aanbod: 
aandacht: 
aandeel: aandelen
aandelen: aandeel anderen
aantal: 
achter: echte echter wachten
actief: 
activiteiten: 
advies: 
afgelopen: 
akkoord: 
aldus: alles
algemeen: algemene
algemene: algemeen
alleen: alles vallen
allemaal: helemaal
allerlei: 
alles: aldus alleen vallen
altijd: 
amerika: 
amerikaanse: 
amper: ander kamer
amsterdam: 
ander: amper andere anderen anders handen ieder kader landen langer manier minder onder vader zonder
andere: ander anderen anders onder
anderen: aandelen ander andere anders kinderen
anders: ander andere anderen onder ouders
antwerpen: antwerpse
antwerpse: antwerpen
antwoord: 
april: 
augustus: 
banken: binnen boeken denken handen landen maken mannen zaken
basis: 
bedraagt: bedrag
bedrag: bedraagt
bedrijf: 
bedrijven: 
beeld: beelden bekend beleid wereld
beelden: beeld bieden
beetje: beste
begin: begint begon bezig bezit tegen
beginnen: begonnen binnen
begint: begin begon bezit
begon: begin begint tegen
begonnen: beginnen
beide: beste derde einde leiden leidt
bekend: beeld beleid boeken weken
belang: 
belangrijk: belangrijke
belangrijke: belangrijk belangrijkste
belangrijkste: belangrijke
beleggers: 
beleid: beeld bekend
belgische: 
bepaald: bepaalde betaalt
bepaalde: bepaald
beperkt: 
beroep: bezoek groep
bestaan: bestaande bestaat staan
bestaande: bestaan
bestaat: bestaan betaalt staat
beste: beetje beide beter eerste meeste rente vaste
bestuur: 
betaalt: bepaald bestaat
betalen: 
betekent: 
beter: beste betere ieder later leger meter peter water weten zeker
betere: beter meter peter
betreft: 
betrokken: 
beurs: buurt
bevolking: 
bezig: begin bezit
bezit: begin begint bezig gezet
bezoek: beroep
bieden: beelden biedt binnen boeken ieder kiezen leden reden vinden
biedt: bieden vindt
bijna: 
bijvoorbeeld: 
bijzonder: 
binnen: banken beginnen bieden dingen gingen kennen kunnen mannen vinden
bleef: bleek
bleek: bleef
blijft: blijkt lijkt
blijkt: blijft lijkt
blijven: lijken
boeken: banken bekend bieden bouwen boven moeten noemen voelen voeren weken zoeken
bouwen: boeken boven houden vrouwen zouden
boven: boeken bouwen geven horen komen kopen leven lopen mogen zeven
bovendien: 
bracht: gebracht kracht macht recht
brengen: brengt kregen
brengt: brengen
britse: duitse
brussel: brusselse
brusselse: brussel
buiten: punten
buitenland: buitenlandse
buitenlandse: buitenland
buurt: beurs
centrale: controle generale
centrum: 
china: 
cijfers: 
concurrentie: 
contract: 
controle: centrale
crisis: 
cultuur: 
daarbij: waarbij
daarmee: waarmee
daarna: daarom daarvan
daarnaast: 
daarom: daarna waarom waarop
daarvan: daarna waarvan
daarvoor: waardoor
dagen: dingen eigen halen jaren lager laten maken mogen namen samen tegen vragen waren zaken
december: 
denken: banken denkt dingen enkel kennen mensen merken weken werken
denkt: denken dienst werkt
derde: beide eerder verder werden
dergelijke: 
dertig: 
dezelfde: hetzelfde
dienst: denkt diensten winst
diensten: dienst
dingen: binnen dagen denken eigen gingen liggen vinden
directeur: 
diverse: 
dollar: 
duidelijk: 
duitse: britse
duitsland: 
echte: achter echter recht
echter: achter echte
economie: 
economische: 
eerder: derde ieder verder werden
eerst: eerste meest tekst werkt
eerste: beste eerst meeste
eigen: dagen dingen enige gingen leggen leiden liggen mogen tegen zeggen
eigenlijk: 
einde: beide minder sinds vinden vindt wilde
elkaar: klaar
enige: eigen
enkel: denken enkele
enkele: enkel
enorme: 
ervan: 
ervaring: 
europa: 
europees: europese
europese: europees
eveneens: 
evolutie: 
extra: 
familie: 
februari: 
frank: franse
frankrijk: 
franse: frank
functie: 
gebeuren: gebeurt
gebeurt: gebeuren
gebied: gezien
gebouw: 
gebracht: bracht
gebruik: gebruiken gebruikt
gebruiken: gebruik gebruikt
gebruikt: gebruik gebruiken
gedaan: 
geeft: geldt gezet heeft helft hoeft meest neemt
gegeven: gegevens geleden geven
gegevens: gegeven
gehad: geval
geheel: gevoel
gehouden: gevonden geworden houden
gekomen: genomen komen
geldt: geeft gezet helft leidt
geleden: gegeven gulden leden verleden
gelijk: mogelijk tegelijk
gemaakt: maakt
gemeente: gemeenten
gemeenten: gemeente
gemiddeld: gemiddelde
gemiddelde: gemiddeld
generale: centrale
genoeg: genoemd genomen gevoel gevolg
genoemd: genoeg
genomen: gekomen genoeg
geschiedenis: 
geschreven: 
gesteld: 
geval: gehad geven gevoel gevolg
gevallen: gevolgen vallen
geven: boven gegeven geval gevoel gezet gezien leden leren leven lezen nemen reden tegen weken weten zeven
gevoel: geheel genoeg geval geven gevolg
gevolg: genoeg geval gevoel gevolgen
gevolgen: gevallen gevolg gevonden volgen
gevonden: gehouden gevolgen geworden
geweest: 
gewone: gewoon
gewoon: gewone
geworden: gehouden gevonden worden
gezegd: gezet
gezet: bezit geeft geldt geven gezegd gezien lezen omzet
gezien: gebied geven gezet lezen
gingen: binnen dingen eigen liggen vinden
gisteren: 
goede: moeder
graag: vraag vraagt
gratis: 
groei: groep grond groot grote groter vroeg
groep: beroep groei grond groot grote groter vroeg
grond: groei groep groot grote stond
groot: groei groep grond grote
grootste: 
grote: groei groep grond groot groter grotere
groter: groei groep grote grotere
grotere: grote groter
gulden: geleden zullen
haalt: maakt maart naast
hadden: halen handen houden landen
halen: dagen hadden handen helpen horen jaren laten maken namen samen vallen waren zaken
handen: ander banken hadden halen houden konden landen londen maanden mannen vinden
hebben: helpen
heeft: geeft helft hoeft meest neemt
helemaal: allemaal
helft: geeft geldt heeft hoeft zelfs
helpen: halen hebben
hetzelfde: dezelfde
hoeft: geeft heeft helft hoofd houdt moest
hoewel: zowel
hoger: hogere horen lager leger mogen zomer
hogere: hoger
honderd: onder zonder
hoofd: hoeft woord
hoofdstad: 
horen: boven halen hoger houden jaren komen kopen leren lopen mogen morgen voeren vormen waren worden zorgen
houden: bouwen gehouden hadden handen horen houdt konden londen worden zouden
houdt: hoeft houden wordt
huidige: 
ieder: ander beter bieden eerder kader leden leger liever meter minder moeder onder peter reden vader verder zeker
iedereen: 
iemand: niemand
immers: 
inderdaad: 
informatie: 
inmiddels: 
internationale: 
internet: 
investeringen: 
invloed: 
italiaanse: 
januari: 
japan: japanse jaren
japanse: japan
jaren: dagen halen horen japan laten leren maken namen samen waren zaken
jonge: jongste lange
jongeren: 
jongste: jonge
juist: juiste kunst
juiste: juist ruimte
kader: ander ieder kamer lager later onder vader water
kamer: amper kader komen kwamen lager later namen samen vader water zomer
kapitaal: 
kennen: binnen denken kennis konden kunnen mannen mensen
kennis: kennen
keuze: 
kiezen: bieden kijken kregen lezen
kijken: kiezen krijgen lijken
kilometer: 
kinderen: anderen
klaar: elkaar klant zwaar
klant: klaar klanten
klanten: klant landen laten plannen
klassieke: 
klein: kleine
kleine: klein
koers: 
komen: boven gekomen horen kamer komende konden kopen kosten kwamen lopen mogen moment namen nemen noemen samen vormen zomer
komende: komen
konden: handen houden kennen komen kopen kosten kunnen landen londen onder vinden worden zonder zouden
kopen: boven horen komen konden kosten lopen mogen
korte: kosten
kosten: komen konden kopen korte moesten moeten
kracht: bracht macht recht
kreeg: kregen steeg vroeg
kregen: brengen kiezen kreeg krijgen reden tegen vragen
krijgen: kijken kregen krijgt prijzen
krijgt: krijgen
kunnen: binnen kennen konden mannen punten
kunst: juist winst
kwaliteit: 
kwamen: kamer komen namen samen waren
laatste: 
lager: dagen hoger kader kamer lange langer laten later leger vader water
landen: ander banken hadden handen klanten konden lange langer laten leden leiden londen maanden mannen plannen vinden
lange: jonge lager landen langer langs
langer: ander lager landen lange langs later leger manier
langs: lange langer onlangs
laten: dagen halen jaren klanten lager landen later leden leren leven lezen lopen maken namen praten samen staten waren water weten zaken
later: beter kader kamer lager langer laten leger meter peter vader water
leden: bieden geleden geven ieder landen laten leger leggen leiden leren leven lezen londen lopen nemen reden tegen weken werden weten zeven
leger: beter hoger ieder lager langer later leden leggen leren leven levert lezen liever meter peter tegen zeker
leggen: eigen leden leger leiden leren leven lezen liggen tegen zeggen
leiden: beide eigen landen leden leggen leidt leren leven lezen londen reden werden
leidt: beide geldt leiden
leren: geven horen jaren laten leden leger leggen leiden leven leveren lezen lopen merken nemen reden tegen voeren waren weken werden werken weten zeven
leven: boven geven laten leden leger leggen leiden leren leveren levert lezen liever lopen nemen reden tegen weken weten zeven
leveren: leren leven levert
levert: leger leven leveren liever
lezen: geven gezet gezien kiezen laten leden leger leggen leiden leren leven lopen nemen reden tegen weken weten zeven
licht: lijkt macht recht slecht
liever: ieder leger leven levert
liggen: dingen eigen gingen leggen lijken zeggen
lijken: blijven kijken liggen lijkt
lijkt: blijft blijkt licht lijken
lokale: totale
londen: handen houden konden landen leden leiden lopen onder vinden worden zonder zouden
loopt: nooit soort toont
lopen: boven horen komen kopen laten leden leren leven lezen londen mogen
maakt: gemaakt haalt maakte maand maart macht markt naast smaak
maakte: maakt maart markt
maand: maakt maanden maart
maanden: handen landen maand mannen
maart: haalt maakt maakte maand macht markt naast start
maastricht: 
maatregelen: 
macht: bracht kracht licht maakt maart markt recht
maken: banken dagen halen jaren laten mannen merken mogen namen samen waren weken zaken
manier: ander langer mannen minder
mannen: banken binnen handen kennen kunnen landen maanden maken manier mensen plannen
markt: maakt maakte maart macht werkt
meerderheid: 
meest: eerst geeft heeft meestal meeste moest neemt tekst
meestal: meest meeste
meeste: beste eerste meest meestal moest moesten
mensen: denken kennen mannen merken meteen
merken: denken leren maken mensen meteen morgen weken werden werken
meteen: mensen merken meter moeten weten zetten
meter: beter betere ieder later leger meteen moeder moeten peter water weten zeker
middelen: 
miljard: 
miljoen: 
minder: ander einde ieder manier moeder onder vinden zonder
minister: 
minstens: minuten
minuten: minstens
misschien: 
moderne: 
moeder: goede ieder meter minder moeten onder zonder
moeilijk: mogelijk
moest: hoeft meest meeste moesten moment
moesten: kosten meeste moest moeten
moeten: boeken kosten meteen meter moeder moesten mogen morgen noemen voelen voeren weten zoeken
mogelijk: gelijk moeilijk mogelijke tegelijk
mogelijke: mogelijk
mogelijkheden: 
mogelijkheid: 
mogen: boven dagen eigen hoger horen komen kopen lopen maken moeten moment morgen tegen volgen zorgen
moment: komen moest mogen
momenteel: 
mooie: nooit
morgen: horen merken moeten mogen volgen vormen worden zorgen
muziek: 
naast: haalt maakt maart
namelijk: 
namen: dagen halen jaren kamer komen kwamen laten maken nemen noemen samen waren zaken
nationale: 
natuurlijk: 
nauwelijks: 
nederland: nederlands nederlandse
nederlands: nederland nederlandse
nederlandse: nederland nederlands
neemt: geeft heeft meest
nemen: geven komen leden leren leven lezen namen noemen reden samen tegen weken weten zeven
niemand: iemand
niets: nieuw nieuws
nieuw: niets nieuwe nieuws opnieuw
nieuwe: nieuw nieuws
nieuws: niets nieuw nieuwe
niveau: 
nodig: nooit vorig
noemen: boeken komen moeten namen nemen voelen voeren vormen zoeken
nogal: 
nooit: loopt mooie nodig soort toont
november: 
nummer: 
ogenblik: 
oktober: 
omdat: omzet zodat
omgeving: 
omzet: gezet omdat
onder: ander andere anders honderd ieder kader konden londen minder moeder ouders vader zonder
onderneming: ondernemingen
ondernemingen: onderneming
onderwijs: 
onderzoek: 
ongeveer: 
onlangs: langs
ontstaan: 
ontwikkeling: 
oorlog: 
opdracht: 
opleiding: 
oplossing: 
opnieuw: nieuw
organisatie: 
ouders: anders onder
overal: 
overheid: 
overigens: 
parijs: partij prijs
parlement: 
partij: parijs partijen
partijen: partij
periode: 
personeel: 
peter: beter betere ieder later leger meter water weten zeker
plaats: plaatsen vlaams
plaatsen: plaats
plannen: klanten landen mannen
politie: politiek politieke positie positief
politiek: politie politieke positie positief
politieke: politie politiek
portefeuille: 
positie: politie politiek positief
positief: politie politiek positie
praktijk: 
praten: laten punten staten vragen
precies: premier
premier: precies
president: 
prijs: parijs vrije
prijzen: krijgen
proberen: problemen
probleem: problemen
problemen: proberen probleem
procent: project
product: producten productie project
producten: product productie
productie: product producten
programma: 
project: procent product
publiek: 
punten: buiten kunnen praten
recente: rente
recht: bracht echte kracht licht macht slecht terecht
reden: bieden geven ieder kregen leden leiden leren leven lezen nemen tegen weken werden weten zeven
reeds: reeks steeds
reeks: reeds
regering: rekening
rekening: regering
rendement: 
rente: beste recente
resultaat: 
resultaten: 
richting: 
risico: 
ruimte: juiste
russische: 
samen: dagen halen jaren kamer komen kwamen laten maken namen nemen staten waren zaken
samenwerking: 
school: 
schreef: 
schrijven: 
sector: 
september: 
sinds: einde vindt
situatie: 
slecht: licht recht slechts
slechts: slecht
smaak: maakt staan staat
sociale: speciale
sommige: 
soort: loopt nooit start toont woord
speciale: sociale
speelt: stelt
spelen: spreken stellen voelen
sprake: spreken
spreken: spelen sprake
staan: bestaan smaak staat start staten steun
staat: bestaat smaak staan start stelt
start: maart soort staan staat stelt sterk
staten: laten praten samen staan
steeds: reeds steeg
steeg: kreeg steeds stelt sterk steun
stellen: spelen
stelt: speelt staat start steeg sterk steun
sterk: start steeg stelt sterke steun
sterke: sterk
steun: staan steeg stelt sterk
stijging: 
stijl: strijd
stond: grond
strijd: stijl
studenten: 
studie: 
stukken: 
succes: 
systeem: 
tafel: 
tegelijk: gelijk mogelijk
tegen: begin begon dagen eigen geven kregen leden leger leggen leren leven lezen mogen nemen reden weken weten zeggen zeven
tegenover: 
tekst: eerst meest
telkens: 
tentoonstelling: 
terecht: recht
termijn: terwijl
terug: 
terwijl: termijn
thuis: 
tijdens: 
toekomst: 
toont: loopt nooit soort
totaal: totale
totale: lokale totaal
traditionele: 
trekken: 
trouwens: vrouwen
tussen: 
tweede: 
twintig: 
uiteindelijk: 
uiteraard: 
vader: ander ieder kader kamer lager later onder verder water
vallen: alleen alles gevallen halen voelen volgen willen zullen
vanaf: 
vandaag: 
vanuit: 
vaste: beste
veranderen: vlaanderen
verband: 
verder: derde eerder ieder vader werden
verenigde: 
verhaal: 
verkiezingen: 
verkocht: verwacht
verkoop: 
verkopen: verloren
verleden: geleden verloren
verlies: 
verloren: verkopen verleden
verschil: 
verschillende: 
vertelt: 
vertrouwen: 
verwacht: verkocht verwachten
verwachten: verwacht
vinden: bieden binnen dingen einde gingen handen konden landen londen minder vindt
vindt: biedt einde sinds vinden winst
vlaams: plaats vlaamse
vlaamse: vlaams
vlaanderen: veranderen
voelen: boeken moeten noemen spelen vallen voeren volgen vormen zoeken
voeren: boeken horen leren moeten noemen voelen volgen vormen zoeken
voldoende: volgende
volgen: gevolgen mogen morgen vallen voelen voeren volgend volgende volgens volgt vormen vragen zorgen
volgend: volgen volgende volgens
volgende: voldoende volgen volgend volgens
volgens: volgen volgend volgende
volgt: volgen zorgt
volledig: volledige
volledige: volledig
vooral: 
voorbeeld: voordeel
voorbije: 
voordeel: voorbeeld
voorlopig: 
voorzien: 
voorzitter: 
vorig: nodig vorige
vorige: vorig vrije
vormen: horen komen morgen noemen voelen voeren volgen worden zorgen
vraag: graag vraagt vroeg
vraagt: graag vraag
vragen: dagen kregen praten volgen
vrije: prijs vorige
vroeg: groei groep kreeg vraag vroeger vrouw
vroeger: vroeg
vrouw: vroeg vrouwen
vrouwen: bouwen trouwens vrouw
waarbij: daarbij waarin
waarde: waarin waarmee waarom waarop
waardoor: daarvoor
waarin: waarbij waarde waarom waarop waarvan waren
waarmee: daarmee waarde
waarom: daarom waarde waarin waarop
waarop: daarom waarde waarin waarom
waarschijnlijk: 
waarvan: daarvan waarin
wachten: achter
wanneer: 
waren: dagen halen horen jaren kwamen laten leren maken namen samen waarin water weken werden werken weten worden zaken zware
water: beter kader kamer lager laten later meter peter vader waren weten
weinig: 
weken: bekend boeken denken geven leden leren leven lezen maken merken nemen reden tegen waren welke werden werken weten zaken zeker zeven zoeken
welke: weken werken werkt wilde
wellicht: 
werden: derde eerder leden leiden leren merken reden verder waren weken werken weten woorden worden
wereld: beeld
werken: denken leren merken waren weken welke werden werkt weten worden
werknemers: 
werkt: denkt eerst markt welke werken wordt
weten: beter geven laten leden leren leven lezen meteen meter moeten nemen peter reden tegen waren water weken werden werken zetten zeven
wijze: wilde witte
wilde: einde welke wijze willen witte
willen: vallen wilde zullen
winst: dienst kunst vindt
witte: wijze wilde zitten
woord: hoofd soort woorden wordt
woorden: werden woord worden
worden: geworden horen houden konden londen morgen vormen waren werden werken woorden wordt zorgen zouden
wordt: houdt werkt woord worden zorgt
zaken: banken dagen halen jaren laten maken namen samen waren weken zeker zeven zoeken
zeggen: eigen leggen liggen tegen zetten zeven zorgen
zeker: beter ieder leger meter peter weken zaken zeven zoeken zomer
zelfs: helft
zetten: meteen weten zeggen zeven zitten
zeven: boven geven leden leren leven lezen nemen reden tegen weken weten zaken zeggen zeker zetten zoeken
zichzelf: 
zitten: witte zetten
zoals: 
zodat: omdat zorgt zowat
zoeken: boeken moeten noemen voelen voeren weken zaken zeker zeven zorgen zouden
zogenaamde: 
zomer: hoger kamer komen zeker zonder zowel
zonder: ander honderd konden londen minder moeder onder zomer zouden
zorgen: horen mogen morgen volgen vormen worden zeggen zoeken zorgt zouden
zorgt: volgt wordt zodat zorgen zowat
zouden: bouwen houden konden londen worden zoeken zonder zorgen
zoveel: zowel
zowat: zodat zorgt zowel
zowel: hoewel zomer zoveel zowat
zullen: gulden vallen willen
zwaar: klaar zware
zware: waren zwaar zwarte
zwarte: zware

