aanbod: aantal
aandacht: 
aandeel: aandelen aantal andere anderen anders handen landen maanden wanneer
aandelen: aandeel andere anderen handen kinderen landen maanden middelen vlaanderen
aantal: aanbod aandeel
achter: actief echter groter wachten
actief: achter advies altijd
activiteiten: 
advies: actief
afgelopen: 
akkoord: antwoord
algemeen: algemene alleen
algemene: algemeen alleen
alleen: algemeen algemene allerlei anderen geleden gulden helpen meteen vallen volgen willen zullen
allemaal: helemaal
allerlei: alleen
altijd: actief partij strijd
amerika: 
amerikaanse: 
amsterdam: 
andere: aandeel aandelen anderen anders betere enkele handen hogere honderd kinderen landen langer manier minder moderne ouders zonder
anderen: aandeel aandelen alleen andere anders antwerpen handen iedereen jongeren kinderen landen leveren noemen veranderen vlaanderen voeren
anders: aandeel andere anderen handen honderd immers landen langer manier minder ouders zonder
antwerpen: anderen antwerpse
antwerpse: antwerpen
antwoord: akkoord
augustus: 
banken: bekend bieden binnen boeken bouwen brengen buiten denken dingen gingen hadden handen kennen kijken klanten konden kunnen landen langer lijken londen maanden manier mannen mensen merken plannen punten vallen vinden werken zoeken
bedraagt: bedrag bestaat betaalt vraagt
bedrag: bedraagt bedrijf belang gedaan
bedrijf: bedrag bedrijven
bedrijven: bedrijf blijven schrijven
beelden: beetje betalen bieden boeken brengen eerder geleden gulden helpen leiden spelen stellen verleden voelen werden
beetje: beelden betere britse meeste
beginnen: begint begonnen binnen gingen kennen
begint: beginnen bekend belang
begonnen: beginnen binnen gevonden kennen
bekend: banken begint belang beleid betekent betere bieden boeken denken gezegd iemand merken telkens wereld werken zoeken
belang: bedrag begint bekend beleid iemand onlangs
belangrijk: belangrijke belangrijkste
belangrijke: belangrijk belangrijkste
belangrijkste: belangrijk belangrijke
beleggers: 
beleid: bekend belang betere gezegd wereld
belgische: 
bepaald: bepaalde betaalt
bepaalde: bepaald bestaande betaalt
beperkt: betere levert
beroep: bezoek eerder genoeg gevoel merken verder verkoop werden werken
bestaan: bestaande bestaat bestuur betaalt betalen gedaan ontstaan
bestaande: bepaalde bestaan bestaat
bestaat: bedraagt bestaan bestaande bestuur betaalt resultaat
bestuur: bestaan bestaat cultuur
betaalt: bedraagt bepaald bepaalde bestaan bestaat betalen betreft gemaakt totaal
betalen: beelden bestaan betaalt betekent betere gevallen meteen staten totale zetten
betekent: bekend betalen betere betreft boeken meteen
betere: andere beetje bekend beleid beperkt betalen betekent betreft grotere hogere leveren levert meteen sterke
betreft: betaalt betekent betere
betrokken: trekken
bevolking: 
bezoek: beroep genoeg gevoel gezien muziek
bieden: banken beelden bekend binnen blijven boeken bouwen brengen buiten dingen geleden gingen gulden hadden handen houden kiezen kijken konden kregen landen leiden liever liggen lijken londen minder moeder moeten noemen spelen tijdens vinden voelen voeren werden willen worden zitten zoeken zouden
bijvoorbeeld: voorbeeld
bijzonder: zonder
binnen: banken beginnen begonnen bieden blijven boeken bouwen brengen buiten denken dingen gingen handen kennen kiezen kijken konden kunnen landen liggen lijken londen mannen mensen minder minuten plannen punten vinden willen zitten
blijft: blijkt blijven krijgt
blijkt: blijft blijven gelijk krijgt lijken
blijven: bedrijven bieden binnen blijft blijkt buiten kijken krijgen liever liggen lijken prijzen
boeken: banken beelden bekend betekent bieden binnen bouwen brengen buiten denken hoewel houden kiezen kijken konden kosten kregen lijken londen merken moeder moesten moeten morgen noemen spelen spreken trekken voelen voeren volgen vormen werken worden zoeken zorgen zouden
bouwen: banken bieden binnen boeken buiten hoewel houden konden kosten londen moeten morgen noemen trouwens voelen voeren volgen vormen vrouwen worden zoeken zorgen zouden
bovendien: 
bracht: brengt gebracht kracht opdracht slecht terecht verwacht vraagt
brengen: banken beelden bieden binnen boeken brengt denken dingen gingen kennen kregen krijgen leggen mensen trekken vragen zeggen
brengt: bracht brengen dienst krijgt vraagt
britse: beetje brussel buiten duitse franse
brussel: britse brusselse tussen
brusselse: brussel
buiten: banken bieden binnen blijven boeken bouwen britse duitse gulden juiste kosten kunnen leiden moeten praten punten ruimte staten tussen zetten zitten zullen
buitenland: buitenlandse duitsland
buitenlandse: buitenland
centrale: centrum contract controle generale
centrum: centrale
cijfers: immers tijdens
concurrentie: 
contract: centrale controle
controle: centrale contract
crisis: gratis risico
cultuur: bestuur
daarbij: daarmee daarna daarom daarvan partij waarbij waarin
daarmee: daarbij daarna daarom daarvan waarde waarmee
daarna: daarbij daarmee daarnaast daarom daarvan waarde waarin waarom waarop waarvan
daarnaast: daarna
daarom: daarbij daarmee daarna daarvan daarvoor waarde waarin waarom waarop
daarvan: daarbij daarmee daarna daarom daarvoor waarin waarvan
daarvoor: daarom daarvan waardoor
december: november september
denken: banken bekend binnen boeken brengen diensten dingen enkele genoeg genomen gezien gingen handen hebben helpen kennen kijken konden kunnen landen leggen leiden lijken londen mannen mensen merken meteen punten telkens trekken vinden werden werken zeggen zetten zoeken
dergelijke: mogelijke tegelijk
dertig: partij weinig
dezelfde: hetzelfde
dienst: brengt diensten diverse
diensten: denken dienst dingen mensen minstens minuten moesten
dingen: banken bieden binnen brengen denken diensten gingen handen kennen kiezen kijken konden kregen krijgen kunnen landen langer leggen liggen lijken londen mannen mensen minder minuten morgen punten vinden volgen vragen willen zeggen zitten zorgen
directeur: 
diverse: dienst
dollar: 
duidelijk: 
duitse: britse buiten juiste ruimte
duitsland: buitenland
echter: achter eerder groter sector wachten
economie: economische
economische: economie
eerder: beelden beroep echter eerste leiden merken minder moeder verder werden werken worden zonder
eerste: eerder juiste meeste
eigenlijk: gelijk mogelijk tegelijk
elkaar: 
enkele: andere denken enorme lokale
enorme: enkele genoemd genomen noemen vormen
ervaring: 
europa: europees europese
europees: europa europese
europese: europa europees
eveneens: 
evolutie: politie
familie: 
februari: 
frankrijk: praktijk
franse: britse japanse
functie: 
gebeuren: gebeurt gebruiken gegeven gehouden geleden leveren
gebeurt: gebeuren gebouw gebruik gebruikt geweest levert
gebied: gebouw geheel gelijk genoeg genoemd gesteld gevoel gezegd gezien hebben
gebouw: gebeurt gebied gebruik genoeg gevoel gevolg gewone gewoon
gebracht: bracht gebruikt kracht opdracht terecht verwacht
gebruik: gebeurt gebouw gebruiken gebruikt
gebruiken: gebeuren gebruik gebruikt
gebruikt: gebeurt gebracht gebruik gebruiken
gedaan: bedrag bestaan gemaakt gewoon gezien
gegeven: gebeuren gegevens geheel gekomen geleden genomen gezien leggen leveren meteen zeggen
gegevens: gegeven geleden
geheel: gebied gegeven geleden genoeg gesteld gevoel geweest gezegd gezien meteen zoveel
gehouden: gebeuren gekomen geleden genomen gevolgen gevonden geworden houden zouden
gekomen: gegeven gehouden geleden genoeg genomen gevoel gevolgen gevonden gewone gewoon geworden gezien verkopen
geleden: alleen beelden bieden gebeuren gegeven gegevens geheel gehouden gekomen genomen gevonden geworden gezien gulden helpen leiden leveren meteen verleden werden
gelijk: blijkt eigenlijk gebied gezien moeilijk mogelijk mogelijke namelijk tegelijk
gemaakt: betaalt gedaan maakte
gemeente: gemeenten geweest meeste recente
gemeenten: gemeente
gemiddeld: gemiddelde inmiddels
gemiddelde: gemiddeld
generale: centrale
genoeg: beroep bezoek denken gebied gebouw geheel gekomen genoemd genomen gevoel gevolg gewone gewoon gezegd gezien gingen kennen mensen
genoemd: enorme gebied genoeg genomen gesteld gevoel gezegd
genomen: denken enorme gegeven gehouden gekomen geleden genoeg genoemd gevoel gevolgen gevonden gewone gewoon geworden gezien gingen kennen mensen noemen
geschiedenis: 
geschreven: 
gesteld: gebied geheel genoemd gevoel gezegd vertelt wereld
gevallen: betalen gevolgen gevonden vallen
gevoel: beroep bezoek gebied gebouw geheel gekomen genoeg genoemd genomen gesteld gevolg gevolgen gevonden gewone gewoon gezien zoveel
gevolg: gebouw genoeg gevoel gevolgen gewone gewoon
gevolgen: gehouden gekomen genomen gevallen gevoel gevolg gevonden geworden volgen volgend volgens
gevonden: begonnen gehouden gekomen geleden genomen gevallen gevoel gevolgen gewone geworden konden londen vinden
geweest: gebeurt geheel gemeente
gewone: gebouw gekomen genoeg genomen gevoel gevolg gevonden gewoon geworden
gewoon: gebouw gedaan gekomen genoeg genomen gevoel gevolg gewone geworden gezien
geworden: gehouden gekomen geleden genomen gevolgen gevonden gewone gewoon werden woorden worden
gezegd: bekend beleid gebied geheel genoeg genoemd gesteld gezien wereld
gezien: bezoek denken gebied gedaan gegeven geheel gekomen geleden gelijk genoeg genomen gevoel gewoon gezegd gingen gulden hebben helpen kennen kiezen leggen leiden mensen merken meteen muziek werden werken zeggen zetten
gingen: banken beginnen bieden binnen brengen denken dingen genoeg genomen gezien gulden handen kennen kiezen kijken konden kregen krijgen kunnen landen langer leggen liggen lijken londen mannen mensen minder minuten morgen punten vinden volgen vragen willen zeggen zitten zorgen
gisteren: grotere kinderen
gratis: crisis groter praten
grootste: grotere
groter: achter echter gratis grotere praten vroeger
grotere: betere gisteren grootste groter hogere proberen
gulden: alleen beelden bieden buiten geleden gezien gingen hadden handen helpen houden konden kunnen landen leiden londen punten tussen vallen vinden volgen werden willen worden zouden zullen
hadden: banken bieden gulden handen hebben helpen houden konden landen leiden londen maanden mannen vallen vinden werden worden zouden
handen: aandeel aandelen andere anderen anders banken bieden binnen denken dingen gingen gulden hadden hebben helpen honderd houden kennen klanten konden kunnen landen langer leiden londen maanden manier mannen mensen minder plannen punten vallen vinden werden worden zonder zouden
hebben: denken gebied gezien hadden handen helpen houden kennen leggen leiden mensen merken meteen werden werken zeggen zetten
helemaal: allemaal
helpen: alleen beelden denken geleden gezien gulden hadden handen hebben houden kennen leggen leiden mensen merken meteen spelen stellen telkens vallen voelen volgen werden werken willen zeggen zetten zullen
hetzelfde: dezelfde
hoewel: boeken bouwen hogere houden moeder moeten noemen voelen voeren zoeken zoveel
hogere: andere betere grotere hoewel honderd jongeren moderne voeren
honderd: andere anders handen hogere houden konden londen minder moeder ouders zonder
hoofdstad: 
houden: bieden boeken bouwen gehouden gulden hadden handen hebben helpen hoewel honderd konden kosten landen leiden londen moeder moeten morgen noemen ouders vinden voelen voeren volgen vormen vrouwen werden woorden worden zoeken zonder zorgen zouden
huidige: 
iedereen: anderen kinderen leveren
iemand: bekend belang niemand verband
immers: anders cijfers nummer ouders
inderdaad: 
informatie: 
inmiddels: gemiddeld
internationale: 
internet: 
investeringen: 
invloed: 
italiaanse: 
januari: 
japanse: franse
jongeren: anderen hogere jongste kinderen voeren
jongste: jongeren juiste
juiste: buiten duitse eerste jongste meeste ruimte
kapitaal: 
kennen: banken beginnen begonnen binnen brengen denken dingen genoeg genomen gezien gingen handen hebben helpen kennis kiezen kijken klanten kleine konden kosten kregen kunnen kwamen landen leggen leiden londen mannen mensen merken meteen plannen punten vinden werden werken zeggen zetten
kennis: kennen kunnen weinig
kiezen: bieden binnen boeken dingen gezien gingen kennen kijken kinderen konden kosten kregen krijgen kunnen kwamen liever liggen lijken moeten noemen prijzen spelen vinden voelen voeren willen zitten zoeken
kijken: banken bieden binnen blijven boeken denken dingen gingen kennen kiezen konden kosten kregen krijgen kunnen kwamen liggen lijken merken miljoen prijzen tijdens vinden werken willen zitten zoeken
kilometer: 
kinderen: aandelen andere anderen gisteren iedereen jongeren kiezen konden middelen minder vinden
klanten: banken handen kennen konden kosten kunnen kwamen landen langer londen maanden mannen plaatsen plannen praten punten staten
klassieke: 
kleine: kennen leiden
komende: konden moment volgende
konden: banken bieden binnen boeken bouwen denken dingen gevonden gingen gulden hadden handen honderd houden kennen kiezen kijken kinderen klanten komende kosten kregen kunnen kwamen landen leiden londen maanden mannen mensen minder moeder moeten morgen noemen punten vinden voelen voeren volgen vormen werden woorden worden zoeken zonder zorgen zouden
kosten: boeken bouwen buiten houden kennen kiezen kijken klanten konden kregen kunnen kwamen londen moesten moeten morgen noemen praten punten staten tussen voelen voeren volgen vormen worden zetten zitten zoeken zorgen zouden
kracht: bracht gebracht krijgt opdracht slecht terecht verwacht vraagt
kregen: bieden boeken brengen dingen gingen kennen kiezen kijken konden kosten krijgen kunnen kwamen leggen liggen moeten morgen noemen praten spelen spreken trekken voelen voeren volgen vragen vroeger zeggen zoeken zorgen
krijgen: blijven brengen dingen gingen kiezen kijken kregen krijgt liggen lijken prijzen vragen
krijgt: blijft blijkt brengt kracht krijgen vraagt
kunnen: banken binnen buiten denken dingen gingen gulden handen kennen kennis kiezen kijken klanten konden kosten kregen kwamen landen londen mannen mensen plannen punten tussen vinden zullen
kwaliteit: 
kwamen: kennen kiezen kijken klanten konden kosten kregen kunnen noemen praten staten vormen vragen
laatste: maakte plaats plaatsen vlaamse
landen: aandeel aandelen andere anderen anders banken bieden binnen denken dingen gingen gulden hadden handen houden kennen klanten konden kunnen langer leggen leiden liggen lijken londen maanden manier mannen mensen minder plannen punten vallen vinden werden worden zonder zouden
langer: andere anders banken dingen gingen handen klanten landen leggen liever liggen londen manier mannen minder plannen wanneer zonder
leggen: brengen denken dingen gegeven gezien gingen hebben helpen kennen kregen landen langer leiden leveren liggen lijken londen mensen merken meteen morgen volgen vragen werden werken zeggen zetten zorgen
leiden: beelden bieden buiten denken eerder geleden gezien gulden hadden handen hebben helpen houden kennen kleine konden landen leggen leveren liggen lijken londen mensen merken meteen verder vinden werden werken worden zeggen zetten zouden
leveren: anderen betere gebeuren gegeven geleden iedereen leggen leiden levert liever meteen voeren
levert: beperkt betere gebeurt leveren liever
liever: bieden blijven kiezen langer leveren levert liggen lijken minder moeder
liggen: bieden binnen blijven dingen gingen kiezen kijken kregen krijgen landen langer leggen leiden liever lijken londen morgen vinden volgen vragen willen zeggen zitten zorgen
lijken: banken bieden binnen blijkt blijven boeken denken dingen gingen kiezen kijken krijgen landen leggen leiden liever liggen londen merken miljoen prijzen tijdens vinden werken willen zitten zoeken
lokale: enkele sociale totale
londen: banken bieden binnen boeken bouwen denken dingen gevonden gingen gulden hadden handen honderd houden kennen klanten konden kosten kunnen landen langer leggen leiden liggen lijken maanden mannen mensen minder moeder moeten morgen noemen plannen punten vinden voelen voeren volgen vormen werden woorden worden zoeken zonder zorgen zouden
maakte: gemaakt laatste maanden meeste waarde zwarte
maanden: aandeel aandelen banken hadden handen klanten konden landen londen maakte manier mannen mensen minder plannen vinden waarde
maastricht: 
maatregelen: 
manier: andere anders banken handen landen langer maanden mannen mensen minder minister moeder muziek wanneer zonder
mannen: banken binnen denken dingen gingen hadden handen kennen klanten konden kunnen landen langer londen maanden manier mensen merken meteen minder minuten moeten morgen plannen punten vallen vinden wanneer
meerderheid: 
meestal: meeste moesten
meeste: beetje eerste gemeente juiste maakte meestal mensen moesten moeten recente
mensen: banken binnen brengen denken diensten dingen genoeg genomen gezien gingen handen hebben helpen kennen konden kunnen landen leggen leiden londen maanden manier mannen meeste merken meteen minder minstens minuten moesten moeten morgen punten tussen vinden werden werken zeggen zetten
merken: banken bekend beroep boeken denken eerder gezien hebben helpen kennen kijken leggen leiden lijken mannen mensen meteen moesten moeten morgen spreken sterke telkens trekken verder verkopen voeren vormen werden werken worden zeggen zetten zoeken zorgen
meteen: alleen betalen betekent betere denken gegeven geheel geleden gezien hebben helpen kennen leggen leiden leveren mannen mensen merken moesten moeten morgen werden werken zeggen zetten zitten
middelen: aandelen kinderen
miljard: miljoen
miljoen: kijken lijken miljard minuten willen
minder: andere anders bieden binnen dingen eerder gingen handen honderd kinderen konden landen langer liever londen maanden manier mannen mensen minister minuten moeder verder vinden zonder
minister: manier minder minstens minuten
minstens: diensten mensen minister minuten moesten
minuten: binnen diensten dingen gingen mannen mensen miljoen minder minister minstens moesten moeten punten vinden zitten
misschien: 
moderne: andere hogere moeder moment
moeder: bieden boeken eerder hoewel honderd houden konden liever londen manier minder moderne moesten moeten morgen noemen ouders verder voelen voeren vroeger worden zoeken zonder zouden
moeilijk: gelijk mogelijk mogelijke
moesten: boeken diensten kosten meestal meeste mensen merken meteen minstens minuten moeder moeten morgen noemen voelen voeren zetten zoeken
moeten: bieden boeken bouwen buiten hoewel houden kiezen konden kosten kregen londen mannen meeste mensen merken meteen minuten moeder moesten moment morgen noemen praten punten spelen staten voelen voeren volgen vormen worden zetten zitten zoeken zorgen zouden
mogelijk: eigenlijk gelijk moeilijk mogelijke namelijk tegelijk
mogelijke: dergelijke gelijk moeilijk mogelijk mogelijkheid tegelijk
mogelijkheden: mogelijkheid
mogelijkheid: mogelijke mogelijkheden
moment: komende moderne moeten momenteel morgen noemen procent vormen
momenteel: moment
morgen: boeken bouwen dingen gingen houden konden kosten kregen leggen liggen londen mannen mensen merken meteen moeder moesten moeten moment noemen voelen voeren volgen volgend volgens vorige vormen vragen werden werken woorden worden zeggen zoeken zorgen zouden
muziek: bezoek gezien manier publiek
namelijk: gelijk mogelijk nauwelijks tegelijk
nationale: 
natuurlijk: 
nauwelijks: namelijk
nederland: nederlands nederlandse
nederlands: nederland nederlandse
nederlandse: nederland nederlands
niemand: iemand noemen
nieuwe: nieuws opnieuw
nieuws: nieuwe opnieuw
niveau: 
noemen: anderen bieden boeken bouwen enorme genomen hoewel houden kiezen konden kosten kregen kwamen londen moeder moesten moeten moment morgen niemand november nummer spelen voelen voeren volgen vormen worden zoeken zorgen zouden
november: december noemen
nummer: immers noemen
ogenblik: 
oktober: 
omgeving: regering
onderneming: ondernemingen
ondernemingen: onderneming
onderwijs: 
onderzoek: 
ongeveer: 
onlangs: belang
ontstaan: bestaan
ontwikkeling: 
oorlog: voorlopig
opdracht: bracht gebracht kracht
opleiding: oplossing
oplossing: opleiding
opnieuw: nieuwe nieuws
organisatie: 
ouders: andere anders honderd houden immers moeder zonder zouden
overal: verhaal vooral zoveel
overheid: 
overigens: 
parijs: partij partijen strijd
parlement: 
partij: altijd daarbij dertig parijs partijen praktijk waarbij
partijen: parijs partij prijzen
periode: 
personeel: 
plaats: laatste plaatsen vlaams vlaamse
plaatsen: klanten laatste plaats plannen praten vlaamse
plannen: banken binnen handen kennen klanten kunnen landen langer londen maanden mannen plaatsen praten punten
politie: evolutie politiek politieke positie positief
politiek: politie politieke positie positief
politieke: politie politiek positie positief
portefeuille: 
positie: politie politiek politieke positief
positief: politie politiek politieke positie
praktijk: frankrijk partij
praten: buiten gratis groter klanten kosten kregen kwamen moeten plaatsen plannen prijzen procent punten sprake spreken staten vragen zetten zitten
precies: premier
premier: precies
president: 
prijzen: blijven kiezen kijken krijgen lijken partijen praten
proberen: grotere probleem problemen voeren
probleem: proberen problemen
problemen: proberen probleem
procent: moment praten product project recente
product: procent producten productie project
producten: product productie
productie: product producten
programma: 
project: procent product
publiek: muziek
punten: banken binnen buiten denken dingen gingen gulden handen kennen klanten konden kosten kunnen landen londen mannen mensen minuten moeten plannen praten staten tussen vinden zetten zitten zullen
recente: gemeente meeste procent
regering: omgeving rekening
rekening: regering
rendement: 
resultaat: bestaat resultaten
resultaten: resultaat
richting: 
risico: crisis
ruimte: buiten duitse juiste
russische: 
samenwerking: 
school: 
schreef: 
schrijven: bedrijven
sector: echter
september: december
situatie: studie
slecht: bracht kracht slechts speelt terecht
slechts: slecht
sociale: lokale speciale totale
sommige: vorige
speciale: sociale
speelt: slecht spelen steeds
spelen: beelden bieden boeken helpen kiezen kregen moeten noemen speelt spreken staten stellen vallen voelen voeren willen zoeken zullen
sprake: praten spreken sterke
spreken: boeken kregen merken praten spelen sprake stukken trekken werken zoeken
staten: betalen buiten klanten kosten kwamen moeten praten punten spelen stellen stukken vragen zetten zitten
steeds: speelt sterke tweede
stellen: beelden helpen spelen staten sterke stukken telkens vallen voelen willen zullen
sterke: betere merken sprake steeds stellen studie stukken werken
stijging: 
strijd: altijd parijs
studenten: 
studie: situatie sterke stukken
stukken: spreken staten stellen sterke studie trekken tussen
succes: 
systeem: 
tegelijk: dergelijke eigenlijk gelijk mogelijk mogelijke namelijk
tegenover: 
telkens: bekend denken helpen merken stellen tijdens trekken volgens werken
tentoonstelling: 
terecht: bracht gebracht kracht slecht verkocht verwacht
termijn: terwijl
terwijl: termijn
tijdens: bieden cijfers kijken lijken telkens vinden
toekomst: 
totaal: betaalt totale vooral
totale: betalen lokale sociale totaal
traditionele: 
trekken: betrokken boeken brengen denken kregen merken spreken stukken telkens werken zoeken
trouwens: bouwen vrouwen
tussen: brussel buiten gulden kosten kunnen mensen punten stukken zullen
tweede: steeds werden
twintig: weinig
uiteindelijk: 
uiteraard: 
vallen: alleen banken gevallen gulden hadden handen helpen landen mannen spelen stellen vinden voelen voeren volgen volgend volgens vormen vragen willen zullen
vandaag: 
vanuit: 
veranderen: anderen vlaanderen
verband: iemand verhaal
verder: beroep eerder leiden merken minder moeder verleden verlies vertelt vinden voeren vormen werden werken worden zonder
verenigde: 
verhaal: overal verband
verkiezingen: 
verkocht: terecht verkoop verkopen verwacht
verkoop: beroep verkocht verkopen
verkopen: gekomen merken verkocht verkoop verleden verloren werken
verleden: beelden geleden verder verkopen verlies verloren werden
verlies: verder verleden verloren
verloren: verkopen verleden verlies
verschil: 
verschillende: 
vertelt: gesteld verder wereld
vertrouwen: vrouwen
verwacht: bracht gebracht kracht terecht verkocht verwachten
verwachten: verwacht wachten
vinden: banken bieden binnen denken dingen gevonden gingen gulden hadden handen houden kennen kiezen kijken kinderen konden kunnen landen leiden liggen lijken londen maanden mannen mensen minder minuten punten tijdens vallen verder voelen voeren volgen vormen vragen werden willen worden zitten zonder zouden
vlaams: plaats vlaamse vraagt
vlaamse: laatste plaats plaatsen vlaams
vlaanderen: aandelen anderen veranderen
voelen: beelden bieden boeken bouwen helpen hoewel houden kiezen konden kosten kregen londen moeder moesten moeten morgen noemen spelen stellen vallen vinden voeren volgen volgend volgens vormen vragen vroeger vrouwen willen worden zoeken zorgen zouden zullen
voeren: anderen bieden boeken bouwen hoewel hogere houden jongeren kiezen konden kosten kregen leveren londen merken moeder moesten moeten morgen noemen proberen spelen vallen verder vinden voelen volgen volgend volgens vooral voorzien vormen vragen vroeger vrouwen werden werken woorden worden zoeken zorgen zouden
voldoende: volgend volgende
volgen: alleen boeken bouwen dingen gevolgen gingen gulden helpen houden konden kosten kregen leggen liggen londen moeten morgen noemen vallen vinden voelen voeren volgend volgende volgens vorige vormen vragen vroeger vrouwen willen worden zeggen zoeken zorgen zouden zullen
volgend: gevolgen morgen vallen voelen voeren voldoende volgen volgende volgens vormen vragen zorgen
volgende: komende voldoende volgen volgend volgens
volgens: gevolgen morgen telkens vallen voelen voeren volgen volgend volgende vormen vragen zorgen
volledig: volledige
volledige: volledig
vooral: overal totaal voeren voordeel
voorbeeld: bijvoorbeeld voordeel
voorbije: voorzien vorige
voordeel: vooral voorbeeld voorzien woorden
voorlopig: oorlog
voorzien: voeren voorbije voordeel voorzitter vormen woorden
voorzitter: voorzien
vorige: morgen sommige volgen voorbije vormen vragen zorgen
vormen: boeken bouwen enorme houden konden kosten kwamen londen merken moeten moment morgen noemen vallen verder vinden voelen voeren volgen volgend volgens voorzien vorige vragen vrouwen werden werken woorden worden zoeken zorgen zouden
vraagt: bedraagt bracht brengt kracht krijgt vlaams vragen
vragen: brengen dingen gingen kregen krijgen kwamen leggen liggen morgen praten staten vallen vinden voelen voeren volgen volgend volgens vorige vormen vraagt vroeger vrouwen zeggen zorgen
vroeger: groter kregen moeder voelen voeren volgen vragen vrouwen
vrouwen: bouwen houden trouwens vertrouwen voelen voeren volgen vormen vragen vroeger zouden
waarbij: daarbij partij waarde waarin waarmee waarom waarop waarvan
waarde: daarmee daarna daarom maakte maanden waarbij waardoor waarin waarmee waarom waarop waarvan werden woorden worden zwarte
waardoor: daarvoor waarde waarom waarop
waarin: daarbij daarna daarom daarvan waarbij waarde waarmee waarom waarop waarvan
waarmee: daarmee waarbij waarde waarin waarom waarop waarvan
waarom: daarna daarom waarbij waarde waardoor waarin waarmee waarop waarvan
waarop: daarna daarom waarbij waarde waardoor waarin waarmee waarom waarvan
waarschijnlijk: 
waarvan: daarna daarvan waarbij waarde waarin waarmee waarom waarop
wachten: achter echter verwachten
wanneer: aandeel langer manier mannen
weinig: dertig kennis twintig
wellicht: 
werden: beelden beroep bieden denken eerder geleden geworden gezien gulden hadden handen hebben helpen houden kennen konden landen leggen leiden londen mensen merken meteen morgen tweede verder verleden vinden voeren vormen waarde wereld werken willen woorden worden zeggen zetten zorgen zouden
wereld: bekend beleid gesteld gezegd vertelt werden werken
werken: banken bekend beroep boeken denken eerder gezien hebben helpen kennen kijken leggen leiden lijken mensen merken meteen morgen spreken sterke telkens trekken verder verkopen voeren vormen werden wereld willen woorden worden zeggen zetten zoeken zorgen
werknemers: 
willen: alleen bieden binnen dingen gingen gulden helpen kiezen kijken liggen lijken miljoen spelen stellen vallen vinden voelen volgen werden werken worden zitten zullen
woorden: geworden houden konden londen morgen voeren voordeel voorzien vormen waarde werden werken worden zorgen zouden
worden: bieden boeken bouwen eerder geworden gulden hadden handen houden konden kosten landen leiden londen merken moeder moeten morgen noemen verder vinden voelen voeren volgen vormen waarde werden werken willen woorden zoeken zonder zorgen zouden
zeggen: brengen denken dingen gegeven gezien gingen hebben helpen kennen kregen leggen leiden liggen mensen merken meteen morgen volgen vragen werden werken zetten zitten zoeken zorgen zouden zullen
zetten: betalen buiten denken gezien hebben helpen kennen kosten leggen leiden mensen merken meteen moesten moeten praten punten staten werden werken zeggen zitten zoeken zorgen zouden zullen
zichzelf: 
zitten: bieden binnen buiten dingen gingen kiezen kijken kosten liggen lijken meteen minuten moeten praten punten staten vinden willen zeggen zetten zoeken zorgen zouden zullen
zoeken: banken bekend bieden boeken bouwen denken hoewel houden kiezen kijken konden kosten kregen lijken londen merken moeder moesten moeten morgen noemen spelen spreken trekken voelen voeren volgen vormen werken worden zeggen zetten zitten zonder zorgen zouden zoveel zullen
zogenaamde: 
zonder: andere anders bijzonder eerder handen honderd houden konden landen langer londen manier minder moeder ouders verder vinden worden zoeken zorgen zouden zoveel
zorgen: boeken bouwen dingen gingen houden konden kosten kregen leggen liggen londen merken moeten morgen noemen voelen voeren volgen volgend volgens vorige vormen vragen werden werken woorden worden zeggen zetten zitten zoeken zonder zouden zoveel zullen
zouden: bieden boeken bouwen gehouden gulden hadden handen houden konden kosten landen leiden londen moeder moeten morgen noemen ouders vinden voelen voeren volgen vormen vrouwen werden woorden worden zeggen zetten zitten zoeken zonder zorgen zoveel zullen
zoveel: geheel gevoel hoewel overal zoeken zonder zorgen zouden
zullen: alleen buiten gulden helpen kunnen punten spelen stellen tussen vallen voelen volgen willen zeggen zetten zitten zoeken zorgen zouden
zwarte: maakte waarde

