ability: quality
access: across address assets process
according: 
account: amount around
across: access address allows almost
action: addition function options
addition: action additional position
additional: addition
address: access across
administration: 
against: analyst
agency: french
agreed: already screen street turned
agreement: 
allows: across almost always
almost: across allows amount august
already: agreed
although: though thought through
always: allows
america: american
american: america
amount: account almost around august
analysis: analyst analysts
analyst: against analysis analysts
analysts: analysis analyst
announced: 
annual: 
another: either further others rather whether
application: applications
applications: application
approach: 
around: account amount groups pounds should
assets: access issues losses markets
association: 
august: almost amount largest
authorities: 
available: 
average: storage
became: because become before income senate
because: became become
become: became because before income record second
before: became become effort memory record report
behind: buying demand period second
believe: 
better: between either leader member rather server whether
between: better
billion: million
british: 
budget: 
building: buying
business: businesses
businesses: business
buying: behind building during having making running saying taking trying
california: 
called: closed killed wanted
campaign: 
cannot: 
capabilities: 
capital: 
central: contract control federal general several
certain: german remain
chairman: 
change: changes charge charges exchange things
changes: change charge charges exchange shares things
charge: change changes charges course exchange shares
charges: change changes charge largest shares
children: 
claims: 
closed: called losses showed
command: comment common company compared demand
comment: command common company current document
commercial: 
commission: 
committee: 
common: command comment company london
communications: 
companies: company company's compared
company: command comment common companies company's compared complex
company's: companies company
compared: command companies company complex computer
complete: complex computer
complex: company compared complete computer simple
computer: compared complete complex computers
computers: computer
concern: longer
conditions: 
conference: 
congress: 
considered: 
continue: continued
continued: continue
contract: central control
control: central contract country
corporate: 
countries: country
country: control countries
course: charge source sources
create: created credit increase private senate
created: create increased reached
credit: create profit
current: comment currently percent
currently: current
customers: 
database: 
december: member november september
decided: declined described designed needed received
decision: design version
declined: decided described designed received
defense: release revenue
demand: behind command german germany remain second
democratic: 
department: 
described: decided declined
design: decision designed version
designed: decided declined design
develop: developed levels
developed: develop development
development: developed
didn't: doesn't
different: 
difficult: 
directly: director
director: directly
discussed: 
display: 
distribution: 
document: comment
doesn't: didn't
dollar: dollars
dollars: dollar
drives: priced prices series
during: buying having making running saying strong taking trying working
earlier: 
earnings: 
economic: economy
economy: economic
effect: effort efforts expect expects offers office
effort: before effect efforts offers report
efforts: effect effort offers reports
either: another better further higher others rather whether within
employees: 
energy: enough general nearly
enough: energy though thought through
environment: 
equipment: 
especially: special
estimated: 
europe: european
european: europe
example: simple
exchange: change changes charge
executive: 
existing: 
expect: effect expected expects
expected: expect expects
expects: effect expect expected
family: 
feature: features future futures return
features: feature figures future futures
federal: central general several
figures: features future futures
financial: 
fiscal: 
following: 
forces: former losses prices series source sources workers
foreign: 
former: forces further longer server workers
french: agency
friday: monday sunday
function: action functions question
functions: function
further: another either former quarter rather whether
future: feature features figures futures return
futures: feature features figures future
general: central energy federal several
german: certain demand germany reagan remain
germany: demand german
getting: growing leading meeting selling
government: 
graphics: 
groups: around growth troops
growing: getting growth looking trading trying
growth: groups growing
hardware: 
having: buying during leading making saying taking trading trying
health: really
higher: either rather rights whether
however: 
important: 
include: included includes including income
included: include includes including
includes: include included including
including: include included includes
income: became become include
increase: create increased
increased: created increase
industrial: industry
industry: industrial
inflation: information
information: inflation
insurance: 
interest: 
interface: 
international: 
investigation: 
investment: 
investors: 
involved: 
issues: assets losses
itself: 
january: 
japanese: 
killed: called
language: 
largest: august charges latest market
latest: largest states
leader: better leaders leading longer member needed server
leaders: leader leading levels members vendors
leading: getting having leader leaders looking making meeting saying selling spending taking trading
levels: develop leaders likely models
likely: levels little
limited: united
little: likely simple single
london: common longer monday
longer: concern former leader london losses manager
looking: growing leading making taking working
losses: assets closed forces issues longer
machine: machines making
machines: machine
macintosh: 
making: buying during having leading looking machine marketing meeting saying taking trading trying working
management: 
manager: longer managers
managers: manager
market: largest marketing markets street
marketing: making market markets meeting
markets: assets market marketing workers
meeting: getting leading making marketing selling
member: better december leader members memory november number numbers server
members: leaders member memory number numbers
memory: before member members record report
method: period
microsoft: 
military: 
million: billion
models: levels months
monday: friday london months sunday
months: models monday points
multiple: 
nation's: national options
national: nation's
nearly: energy really
necessary: 
needed: decided leader
network: networks
networks: network
november: december member number
nuclear: number
number: member members november nuclear numbers
numbers: member members number
october: 
offered: offering offers office officer
offering: offered offers
offers: effect effort efforts offered offering office officer others workers
office: effect offered offers officer official police
officer: offered offers office official
official: office officer officials
officials: official
operating: operation operations
operation: operating operations
operations: operating operation options
options: action nation's operations
others: another either offers rather workers
output: 
outside: 
package: 
particularly: 
people: problem simple
percent: current present recent
performance: 
period: behind method priced senior series version
personal: 
planned: wanted
points: months pounds prices printer profits things
police: office policy priced prices produce provide public source volume
policy: police public
political: 
position: addition
possible: 
potential: 
pounds: around points
present: percent presented president project recent result
presented: present
president: present
pressure: 
previous: provides
priced: drives period police prices printer process provided united
prices: drives forces points police priced printer process provides series services
printer: points priced prices private
private: create printer provide
probably: 
problem: people problems program
problems: problem process programs
process: access priced prices problems processing processor profits project
processing: process processor
processor: process processing
produce: police product products project provide reduce
product: produce production products profit project reduce
production: product products
products: produce product production profits project
profit: credit product profits project provide
profits: points process products profit provide provides
program: problem programs
programming: 
programs: problems program
project: present process produce product products profit robert
proposal: proposed
proposed: proposal provided
provide: police private produce profit profits provided provides
provided: priced proposed provide provides
provides: previous prices profits provide provided
public: police policy
purchase: 
quality: ability
quarter: further started
question: function
rather: another better either further higher others reached whether
reached: created rather record
reagan: german really reason remain return
really: health nearly reagan reason result
reason: reagan really remain return version
received: decided declined released required
recent: percent present recently record report result revenue robert second
recently: recent
record: become before memory reached recent report reported reports return second
reduce: produce product require result return
release: defense released revenue
released: received release
remain: certain demand german reagan reason return
report: before effort memory recent record reported reports result return robert support
reported: record report reports
reports: efforts record report reported results supports
require: reduce required requires return
required: received require requires
requirements: 
requires: require required
research: 
response: 
result: present really recent reduce report results return
results: reports result
return: feature future reagan reason record reduce remain report require result
revenue: defense recent release
review: series soviet
rights: higher
robert: project recent report
running: buying during training
saturday: sunday
saying: buying during having leading making selling strong taking trading trying
scheduled: 
school: should
screen: agreed series server street
second: become behind demand recent record strong
securities: security
security: securities
selling: getting leading meeting saying spending
senate: became create senior separate single states
senior: period senate series server vendors
separate: senate
september: december
series: drives forces period prices review screen senior server service services shares sources soviet states street
server: better former leader member screen senior series service services several street
service: series server services
services: prices series server service
several: central federal general server
shares: changes charge charges series showed sources started states
should: around school showed though
showed: closed shares should
significant: 
similar: simple
simple: complex example little people similar single supply
single: little senate simple
software: 
something: 
source: course forces police sources
sources: course forces series shares source
soviet: review series street
special: especially specific
specific: special
spending: leading selling
spokesman: 
standard: standards
standards: standard
started: quarter shares states street turned wanted
statement: 
states: latest senate series shares started stocks strategy street system systems
stocks: states
storage: average
strategy: states
street: agreed market screen series server soviet started states strong
strong: during saying second street trying
structure: 
students: 
sunday: friday monday saturday supply tuesday
supply: simple sunday support
support: report supply supports
supports: reports support
system: states systems
systems: states system
taking: buying during having leading looking making saying things trading training trying working
technical: 
technology: 
telephone: 
television: 
things: change changes points taking though trying
though: although enough should things thought through
thought: although enough though through
through: although enough though thought
thursday: tuesday
together: whether
toward: 
trading: growing having leading making saying taking training trying
training: running taking trading trying
troops: groups
trying: buying during growing having making saying strong taking things trading training working
tuesday: sunday thursday
turned: agreed started
united: limited priced wanted
university: 
various: 
vendors: leaders senior windows
version: decision design period reason
volume: police
wanted: called planned started united
washington: 
wednesday: 
whether: another better either further higher rather together
windows: vendors
within: either without
without: within
workers: forces former markets offers others working
working: during looking making taking trying workers
yesterday: 

