abend: haben
aktien: alten
allein: allem allen aller alles alten
allem: allein allen aller alles alten
allen: allein allem aller alles alten augen halten sollen wollen zahlen
aller: allein allem allen alles alten
allerdings: 
alles: allein allem allen aller alten
alten: aktien allein allem allen aller alles augen daten eltern gelten guten halten hatten osten
amerikanische: amerikanischen
amerikanischen: amerikanische
andere: anderem anderen anderer anderes anders unsere ändern
anderem: andere anderen anderer anderes anders
anderen: andere anderem anderer anderes anders deren ändern
anderer: andere anderem anderen anderes anders unserer
anderes: andere anderem anderen anderer anders
anders: andere anderem anderen anderer anderes landes ändern
anfang: 
angaben: 
angebot: 
angesichts: 
angst: august längst
ansicht: nicht sicht
anteil: urteil
april: 
arbeit: arbeiten
arbeiten: arbeit
arbeitsplätze: 
aufgabe: 
aufgrund: 
auftrag: 
augen: allen alten gegen guten jungen langen sagen tagen wegen
august: angst
ausland: rußland
ausstellung: 
außerdem: 
banken: ganzen langen
bayern: 
bedeutet: 
bedeutung: 
begann: beginn beginnt bekannt
beginn: begann beginnt region
beginnt: begann beginn bekannt
behörden: gehören
beide: beiden keine meine reihe seine seite weise werde
beiden: beide besten bleiben boden einen jeden keinen seien seinen seiten werden zeigen zeiten
beispiel: 
beispielsweise: 
bekannt: begann beginnt genannt
bekommen: gekommen genommen kommen
bereich: bereit bereits bericht
bereit: bereich bereits berlin derzeit streit verein
bereits: bereich bereit
bericht: bereich berichtet gericht leicht spricht
berichtet: bericht berichtete
berichtete: berichtet
berlin: bereit berliner verein
berliner: berlin
besonders: 
besser: besten bisher dessen wasser
besteht: besten steht
besten: beiden besser besteht bieten dessen ersten gelten gestern kosten meisten osten seiten westen zeiten
besucher: 
betonte: 
bevor: zuvor
bevölkerung: 
bezeichnet: 
bieten: besten bietet bremen diesen liegen sieben vielen ziehen
bietet: bieten
bilder: bisher kinder wieder
bisher: besser bilder sicher
bislang: 
bleiben: beiden bleibt kleinen leben
bleibt: bleiben
blick: blieb
blieb: blick liebe
boden: beiden hohen jeden worden
bonner: männer
braucht: 
bremen: bieten
bringen: bringt
bringt: bringen
bundesregierung: 
bundesrepublik: 
börse: 
bühne: 
bürger: 
bürgermeister: 
chance: chancen
chancen: chance
china: 
dabei: daher daten haben
dadurch: durch
dafür: daher
dagegen: gegen
daher: dabei dafür daten vater
damals: 
damit: darin
danach: 
daran: darauf darin darum daten davon deren japan waren
darauf: daran darum
darin: damit daran darum daten davon deren paris waren
darum: daran darauf darin warum
darunter: 
darüber: 
daten: alten dabei daher daran darin davon denen deren guten haben halten hatten kamen namen osten sagen tagen vater waren
davon: daran darin daten
denen: daten deren dessen diesen einen geben gegen gehen ihnen jeden keinen leben neben neuen sehen seien seinen wegen
dennoch: 
deren: anderen daran darin daten denen dessen diesen dürfen geben gegen gehen ihren jeden leben neben neuen sehen seien verein waren wegen werden wären
derzeit: bereit
deshalb: 
dessen: besser besten denen deren diesen lassen müssen westen wissen
deutlich: 
deutsche: deutschen
deutschen: deutsche
deutschland: 
dezember: 
dienstag: 
diese: diesem diesen dieser dieses liebe viele
diesem: diese diesen dieser dieses
diesen: bieten denen deren dessen diese diesem dieser dieses liegen sieben vielen wissen ziehen
dieser: diese diesem diesen dieses wieder
dieses: diese diesem diesen dieser
direkt: 
diskussion: 
dollar: 
donnerstag: 
drittel: dritten mittel
dritten: drittel
druck: 
durch: dadurch
durchaus: 
dürfen: deren dürfte würden
dürfte: dürfen
ebenfalls: jedenfalls
ebenso: 
ehemalige: ehemaligen
ehemaligen: ehemalige
eigene: eigenen einen zeigen
eigenen: eigene einen
eigentlich: 
einem: einen einer eines einst indem keine keinen keiner meine seine seinem seinen seiner seines
einen: beiden denen eigene eigenen einem einer eines einigen einst finden ihnen keine keinen keiner kleinen meine seien seine seinem seinen seiner seines seiten zeigen zeiten
einer: einem einen eines einst hinter keine keinen keiner kinder leiter meine seine seinem seinen seiner seines weiter
eines: einem einen einer einst keine keinen keiner meine seine seinem seinen seiner seines
einfach: 
einige: einigen einzige wenige
einigen: einen einige einzige wenigen
einmal: 
einsatz: einst
einst: einem einen einer eines einsatz kunst meint meist sonst
einzelnen: 
einzige: einige einigen
eltern: alten gelten gestern
endlich: 
entscheiden: entscheidung entschieden
entscheidung: entscheiden
entschieden: entscheiden
entwickelt: 
entwicklung: 
erfolg: 
ergebnis: 
erhalten: erwarten halten
erklärt: erklärte
erklärte: erklärt
erneut: 
erreichen: erreicht
erreicht: erreichen
erste: ersten
ersten: besten erste kosten meisten osten westen
erstmals: 
erwarten: erhalten erwartet
erwartet: erwarten
erzählt: 
etwas: 
europa: 
europäischen: 
experten: 
familie: 
februar: 
finden: einen findet firmen indem kinder kindern kunden
findet: finden indem kinder
firma: firmen
firmen: finden firma
folge: folgen frage rolle solle wolle zufolge
folgen: folge fragen sollen wollen
fordert: forderte
forderte: fordert
frage: folge fragen frauen tragen
fragen: folgen frage frauen sagen tagen tragen
frankfurt: frankfurter
frankfurter: frankfurt
frankreich: 
französischen: 
frauen: frage fragen tragen
freilich: 
freitag: 
früher: früheren
früheren: früher führen
funktion: 
fällt: 
führen: früheren führt führung ihren jahren
führt: führen geführt
führung: führen
ganze: ganzen lange
ganzen: banken ganze langen
geben: denen deren gegeben gegen gehen gelten guten haben jeden leben neben neuen sehen seien sieben wegen
gebracht: gemacht gericht
gefahr: geführt
gefunden: 
geführt: führt gefahr
gegeben: geben gegen gesehen gewesen
gegen: augen dagegen denen deren geben gegeben gehen gelten guten jeden leben liegen neben neuen sagen sehen seien tagen wegen zeigen
gegenüber: 
gehen: denen deren geben gegen gehören gelten gesehen guten hohen jeden leben neben nehmen neuen sehen seien stehen wegen ziehen
gehören: behörden gehen gehört
gehört: gehören
gekommen: bekommen genommen kommen
gelten: alten besten eltern geben gegen gehen gestern guten halten helfen seiten westen zeiten
gemacht: gebracht gericht macht
gemeinsam: 
genannt: bekannt
genau: genug
genommen: bekommen gekommen
genug: genau wenig
geplant: geplanten
geplanten: geplant
gerade: werde
gericht: bericht gebracht gemacht leicht spricht
gesagt: gesamte gewalt
gesamte: gesagt gesamten
gesamten: gesamte
geschichte: 
geschäft: 
gesehen: gegeben gehen gewesen sehen
gesellschaft: 
gesetz: gesetzt
gesetzt: gesetz setzt
gespräch: 
gestellt: stellt
gestern: besten eltern gelten westen
gewalt: gesagt
gewesen: gegeben gesehen
gewinnen: 
geworden: worden
gleich: gleichen leicht zugleich
gleichen: gleich
gleichzeitig: 
große: großen großer größte
großen: große großer größten grünen
großer: große großen
grund: 
gruppe: 
größte: große größten
größten: großen größte
grünen: großen
guten: alten augen daten geben gegen gehen gelten mußten osten
haben: abend dabei daten geben halten hatten hohen kamen leben namen neben sagen tagen waren
halten: allen alten daten erhalten gelten haben hatte hatten helfen hätten
hamburg: hamburger
hamburger: hamburg
handel: handelt landes
handelt: handel
hatte: halten hatten hause heute hätte hätten mitte sagte
hatten: alten daten haben halten hatte hätte hätten
hauptstadt: 
hause: hatte heute
heißt: meint meist zeigt
helfen: gelten halten hilfe
heraus: hinaus
heute: hatte hause hätte leute seite
heutigen: 
hilfe: helfen hälfte
hinaus: heraus
hingegen: 
hinter: einer kinder unter
hohen: boden gehen haben sehen wochen
hälfte: hilfe hätte
hätte: hatte hatten heute hälfte hätten mitte
hätten: halten hatte hatten hätte
häufig: 
ihnen: denen einen ihrem ihren ihrer ihres
ihrem: ihnen ihren ihrer ihres indem
ihren: deren führen ihnen ihrem ihrer ihres jahren waren wären
ihrer: ihnen ihrem ihren ihres immer
ihres: ihnen ihrem ihren ihrer jahres
immer: ihrer sommer
immerhin: 
indem: einem finden findet ihrem jedem kinder zudem
industrie: 
informationen: 
innerhalb: 
insbesondere: 
insgesamt: 
interesse: 
internationalen: 
internet: 
inzwischen: zwischen
italien: 
jahre: jahren jahres
jahren: führen ihren jahre jahres rahmen waren zahlen
jahres: ihres jahre jahren
januar: 
japan: daran
jedem: indem jeden jeder jedes weder zudem
jeden: beiden boden denen deren geben gegen gehen jedem jeder jedes leben medien neben neuen sehen seien weder wegen werden
jedenfalls: ebenfalls
jeder: jedem jeden jedes meter neuer peter weder wieder
jedes: jedem jeden jeder neues weder
jedoch: 
jetzt: letzte setzt
jeweils: 
junge: jungen lange
jungen: augen junge kunden langen
jährlich: 
kamen: daten haben kampf kommen namen rahmen sagen tagen waren
kampf: kamen
keine: beide einem einen einer eines keinen keiner kleine kleinen könne meine meint meinte reihe seine seinem seinen seiner seines seite weise
keinen: beiden denen einem einen einer eines keine keiner kleine kleinen können meine seien seine seinem seinen seiner seines seiten zeigen zeiten
keiner: einem einen einer eines keine keinen kinder kleine kleinen leiter meine seine seinem seinen seiner seines weiter
kilometer: 
kinder: bilder einer finden findet hinter indem keiner kindern kunden länder wieder
kindern: finden kinder kunden ländern sondern ändern
kirche: 
kleine: keine keinen keiner kleinen meine seine
kleinen: bleiben einen keine keinen keiner kleine seinen
knapp: 
koalition: 
kollegen: 
kommen: bekommen gekommen kamen kommt kosten sommer
kommenden: 
kommt: kommen nimmt
konnte: konnten könne könnte könnten monate
konnten: konnte kosten können könnte könnten monaten
konzept: 
kosten: besten ersten kommen konnten osten westen
kreis: preis
krieg: 
kritik: 
kultur: 
kunden: finden jungen kinder kindern können stunden wurden
kunst: einst sonst
könne: keine konnte können könnte könnten
können: keinen konnten kunden könne könnte könnten
könnte: konnte konnten könne können könnten
könnten: konnte konnten könne können könnte
künftig: 
landes: anders handel lange langen länder
lange: ganze junge landes langen
langen: augen banken ganzen jungen landes lange lassen liegen sagen tagen
lassen: dessen langen müssen wasser wissen
leben: bleiben denen deren geben gegen gehen haben jeden liebe liegen neben neuen sehen seien sieben wegen
lediglich: 
leicht: bericht gericht gleich nicht recht sicht
leiter: einer keiner leute meter peter seiner seite seiten weiter weitere zeiten
letzte: jetzt letzten leute setzt
letzten: letzte setzen
leute: heute leiter letzte seite
liebe: blieb diese leben liegen liegt sieben viele
liegen: bieten diesen gegen langen leben liebe liegt sieben vielen wegen ziehen
liegt: liebe liegen sieht
london: 
länder: kinder landes ländern männer ändern
ländern: kindern länder sondern ändern
längst: angst
läuft: 
lösung: 
machen: macht machte mädchen münchen sache suchen wochen
macht: gemacht machen machte markt möchte nacht nicht recht sache sicht
machte: machen macht möchte nacht sache
mannschaft: 
markt: macht
medien: jeden seien
mehrere: 
mehrheit: 
meine: beide einem einen einer eines keine keinen keiner kleine meint meinte meist reihe seine seinem seinen seiner seines seite weise
meint: einst heißt keine meine meinte meist seine zeigt
meinte: keine meine meint meist meisten mitte seine seite teilte zeigte
meinung: 
meist: einst heißt meine meint meinte meisten weise zeigt
meisten: besten ersten meinte meist seiten westen zeiten
mensch: menschen
menschen: mensch münchen
meter: jeder leiter mutter neuer peter unter vater weder weiter
milliarden: 
millionen: 
mindestens: 
minister: 
ministerpräsident: 
minuten: monaten
mitarbeiter: 
mitglieder: 
mitte: hatte hätte meinte mittel mutter mußte
mittel: drittel mitte mutter titel
mittlerweile: 
mittwoch: 
monate: konnte monaten
monaten: konnten minuten monate
montag: sonntag
moskau: 
musik: 
mutter: meter mitte mittel mußte mußten unter
mußte: mitte mutter mußten müßten
mußten: guten mutter mußte müßten
mädchen: machen münchen
männer: bonner länder
möchte: macht machte
möglich: 
möglichkeit: 
münchen: machen menschen mädchen münchner
münchner: münchen
müsse: müssen
müssen: dessen lassen müsse müßten wissen
müßten: mußte mußten müssen
nachdem: 
nacht: macht machte nicht nichts recht sache sicht
namen: daten haben kamen neben nehmen neuen rahmen sagen tagen waren
natürlich: 
neben: denen deren geben gegen gehen haben jeden leben namen nehmen neuen neuer neues sehen seien sieben wegen
nehmen: gehen namen neben neuen rahmen sehen
neuen: denen deren geben gegen gehen jeden leben namen neben nehmen neuer neues sehen seien wegen
neuer: jeder meter neben neuen neues peter weder
neues: jedes neben neuen neuer
nicht: ansicht leicht macht nacht nichts nimmt recht sicht sieht
nichts: nacht nicht sicht
niemand: 
nimmt: kommt nicht
november: 
nächsten: 
nämlich: 
obwohl: sowohl
offen: opfer osten
offenbar: 
ohnehin: 
oktober: 
opfer: offen
osten: alten besten daten ersten guten kosten offen westen
paris: darin preis
parlament: 
partei: parteien
parteien: partei
personen: 
peter: jeder leiter meter neuer später unter vater weder weiter
platz: 
politik: politiker
politiker: politik
politische: politischen
politischen: politische
polizei: 
position: 
preis: kreis paris
problem: probleme
probleme: problem
produktion: 
programm: 
projekt: prozent
prozent: projekt
präsident: präsidenten
präsidenten: präsident
publikum: 
punkte: 
rahmen: jahren kamen namen nehmen zahlen
rechnen: 
recht: leicht macht nacht nicht reihe sechs sicht
regierung: 
region: beginn
reihe: beide keine meine recht seine seite weise
richter: richtig sicher tochter
richtig: richter richtung wichtig
richtung: richtig
rolle: folge solle sollen sollte wolle wollen wollte
roman: 
russischen: 
rußland: ausland
sache: machen macht machte nacht sagte sechs sicher sicht solche sprache suchen woche
sagen: augen daten fragen gegen haben kamen langen namen sagte sehen seien tagen tragen waren wegen
sagte: hatte sache sagen seite
saison: 
samstag: 
schaffen: 
scheint: schritt
schließlich: 
schnell: 
schon: sehen suchen
schritt: scheint
schule: schüler
schwer: schüler sicher
schüler: schule schwer
sechs: recht sache sicht
sehen: denen deren geben gegen gehen gesehen hohen jeden leben neben nehmen neuen sagen schon seien seinen seiten setzen sieben stehen suchen wegen ziehen
seien: beiden denen deren einen geben gegen gehen jeden keinen leben medien neben neuen sagen sehen seine seinem seinen seiner seines seite seiten setzen sieben spiel stehen wegen zeigen zeiten
seine: beide einem einen einer eines keine keinen keiner kleine meine meint meinte reihe seien seinem seinen seiner seines seite seiten weise
seinem: einem einen einer eines keine keinen keiner meine seien seine seinen seiner seines seite seiten
seinen: beiden denen einem einen einer eines keine keinen keiner kleinen meine sehen seien seine seinem seiner seines seite seiten setzen zeigen zeiten
seiner: einem einen einer eines keine keinen keiner leiter meine seien seine seinem seinen seines seite seiten weiter
seines: einem einen einer eines keine keinen keiner meine seien seine seinem seinen seiner seite seiten
seite: beide heute keine leiter leute meine meinte reihe sagte seien seine seinem seinen seiner seines seiten teilte weise weiter zeigte zeiten zweite
seiten: beiden besten einen gelten keinen leiter meisten sehen seien seine seinem seinen seiner seines seite setzen weiter westen zeigen zeiten zweiten
selbst: 
september: 
setzen: letzten sehen seien seinen seiten setzt
setzt: gesetzt jetzt letzte setzen
sicher: bisher richter sache schwer sicht suchen
sicherheit: 
sicht: ansicht leicht macht nacht nicht nichts recht sache sechs sicher sieht spricht steht
sieben: bieten diesen geben leben liebe liegen neben sehen seien spielen stehen vielen ziehen
sieht: liegt nicht sicht spielt steht
situation: 
sofort: 
sogar: 
sogenannten: 
solche: sache solchen solle sollte welche woche
solchen: solche sollen sollten suchen wochen
soldaten: sollten
solle: folge rolle solche sollen sollte sollten sowie stelle wolle wollen wollte
sollen: allen folgen rolle solchen solle sollte sollten stellen wolle wollen wollten
sollte: rolle solche solle sollen sollten stellte wolle wollte wollten
sollten: solchen soldaten solle sollen sollte wollen wollte wollten
sommer: immer kommen
sondern: kindern ländern ändern
sonntag: montag
sonst: einst kunst
sowie: solle
sowohl: obwohl
spiel: seien spielen spieler spielt
spielen: sieben spiel spieler spielt vielen
spieler: spiel spielen spielt
spielt: sieht spiel spielen spieler
sprach: sprache spricht
sprache: sache sprach sprechen sprecher spricht
sprechen: sprache sprecher
sprecher: sprache sprechen
spricht: bericht gericht sicht sprach sprache
später: peter
staat: staaten stadt stand stark statt steht
staaten: staat
stadt: staat stand stark statt steht
stand: staat stadt stark statt stunde
stark: staat stadt stand statt stück
statt: staat stadt stand stark steht stets
stehen: gehen sehen seien sieben steht stellen suchen ziehen
steht: besteht sicht sieht staat stadt statt stehen stellt stets streit
stelle: solle stellen stellt stellte
stellen: sollen stehen stelle stellt stellte
stellt: gestellt steht stelle stellen stellte
stellte: sollte stelle stellen stellt teilte
stets: statt steht
stimmen: 
straße: 
streit: bereit steht
studenten: 
stunde: stand stunden
stunden: kunden stunde
stuttgart: stuttgarter
stuttgarter: stuttgart
stärker: 
stück: stark
suchen: machen sache schon sehen sicher solchen stehen wochen
system: 
tagen: augen daten fragen gegen haben kamen langen namen sagen tragen waren wegen
tatsächlich: 
teilte: meinte seite stellte zeigte
theater: 
thema: 
titel: mittel
tochter: richter
tragen: frage fragen frauen sagen tagen
trainer: 
trotz: 
umsatz: 
universität: 
unsere: andere unserer unter
unserer: anderer unsere
unter: hinter meter mutter peter unsere vater
unternehmen: 
unterstützung: 
urteil: anteil
vater: daher daten meter peter unter
verein: bereit berlin deren
verfahren: 
verfügung: 
vergangenen: 
vergangenheit: 
vergleich: 
verhandlungen: 
verhindern: 
verkauft: 
verlassen: 
verletzt: 
verloren: 
verschiedenen: 
versucht: 
vertreter: 
verwendet: 
viele: diese liebe vielen
vielen: bieten diesen liegen sieben spielen viele ziehen
vielleicht: 
vorbei: 
vorjahr: 
vorsitzende: 
völlig: 
waren: daran darin daten deren haben ihren jahren kamen namen sagen tagen warum wegen werden worden wurden wären würden
warum: darum waren
wasser: besser lassen wissen
weder: jedem jeden jeder jedes meter neuer peter wegen weiter werde werden wieder
wegen: augen denen deren geben gegen gehen jeden leben liegen neben neuen sagen sehen seien tagen waren weder wenigen werden westen wären zeigen
weise: beide keine meine meist reihe seine seite weiter wenige werde zweite
weiter: einer keiner leiter meter peter seiner seite seiten weder weise weitere weiteren weniger westen zeiten zweite zweiten
weitere: leiter weiter weiteren
weiteren: weiter weitere weiterhin
weiterhin: weiteren
welche: solche woche
weltweit: 
wenig: genug wenige wenigen weniger
wenige: einige weise wenig wenigen weniger
wenigen: einigen wegen wenig wenige weniger zeigen
weniger: weiter wenig wenige wenigen
werde: beide gerade weder weise werden worden wurde wurden würde würden
werden: beiden deren jeden waren weder wegen werde westen worden wurde wurden wären würde würden
westen: besten dessen ersten gelten gestern kosten meisten osten seiten wegen weiter werden wissen zeiten zweiten
wichtig: richtig
wieder: bilder dieser jeder kinder weder
wirklich: 
wirtschaft: 
wissen: dessen diesen lassen müssen wasser westen
woche: sache solche welche wochen wolle
wochen: hohen machen solchen suchen woche wollen worden
wochenende: 
wolle: folge rolle solle sollen sollte woche wollen wollte wollten
wollen: allen folgen rolle solle sollen sollten wochen wolle wollte wollten worden wählen
wollte: rolle solle sollte sollten wolle wollen wollten
wollten: sollen sollte sollten wolle wollen wollte
worden: boden geworden waren werde werden wochen wollen wurde wurden wären würde würden
wurde: werde werden worden wurden würde würden
wurden: kunden waren werde werden worden wurde wären würde würden
wählen: wollen während wären zahlen
während: wählen wären
wären: deren ihren waren wegen werden worden wurden wählen während würden
würde: werde werden worden wurde wurden würden
würden: dürfen waren werde werden worden wurde wurden wären würde
zahlen: allen jahren rahmen wählen
zeigen: beiden eigene einen gegen keinen seien seinen seiten wegen wenigen zeigt zeigte zeiten zweiten
zeigt: heißt meint meist zeigen zeigte
zeigte: meinte seite teilte zeigen zeigt zeiten zweite
zeiten: beiden besten einen gelten keinen leiter meisten seien seinen seite seiten weiter westen zeigen zeigte zweite zweiten
ziehen: bieten diesen gehen liegen sehen sieben stehen vielen
zudem: indem jedem
zufolge: folge
zugleich: gleich
zukunft: 
zuletzt: 
zumindest: 
zunächst: 
zurück: 
zusammen: 
zusammenarbeit: 
zusammenhang: 
zuschauer: 
zuvor: bevor
zweite: seite weise weiter zeigte zeiten zweiten
zweiten: seiten weiter westen zeigen zeiten zweite
zwischen: inzwischen
zwölf: 
ändern: andere anderen anders kindern länder ländern sondern
öffentlichen: 
öffentlichkeit: 
überhaupt: 
übernehmen: 

