accord: 
acheter: 
actifs: action actions
action: actifs actions l'action
actionnaires: 
actions: actifs action d'actions
activité: activités
activités: activité
actuel: actuelle
actuelle: actuel
actuellement: 
affaires: d'affaires
affiche: 
ailleurs: d'ailleurs
ainsi: aussi
allemagne: 
alors: avons
américain: américaine
américaine: américain
analystes: 
année: années l'année
années: année données
appel: 
assez: passe passer
atteindre: 
atteint: 
aucun: aucune qu'un
aucune: aucun qu'une
aujourd'hui: 
aurait: autant avait durant serait
aussi: ainsi hausse
autant: aurait avant ayant d'autant durant quant étant
autorités: 
autour: retour
autre: autres entre haute l'autre notre outre quatre titre votre
autres: autre d'autres outre titres
avaient: avait avant vient étaient
avait: aurait avaient avant avoir avril ayant était
avant: autant avaient avait avons ayant devant quant étant
avoir: avait avons avril d'avoir savoir voire
avons: alors avant avoir
avril: avait avoir
ayant: autant avait avant quant étant
baisse: hausse passe
banque: banques manque marque
banques: banque jacques manque
beaucoup: 
belgacom: 
belge: belges belle celle telle
belges: belge belle celles elles
belgique: 
belle: belge belges celle celles elles salle seule telle ville
besoin: 
biens: tient tiers vient
blanc: franc lancé
bonne: bonnes connu donne donner donné monde
bonnes: bonne donne donner données
bourse: cours jours
bruxelles: 
budget: 
bureau: 
bénéfice: bénéfices
bénéfices: bénéfice
bénéficiaire: 
c'est: n'est s'est
cadre: carte cause faire
campagne: compagnie
capacité: 
capital: 
carte: cadre cause cette charge chute forte haute large parce parle parti partie perte porte sorte
cause: cadre carte chose chute crise hausse haute passe
celle: belge belle celles celui cette elles salle seule telle ville
celle-ci: celui-ci
celles: belges belle celle elles telle
celui: celle
celui-ci: celle-ci
centrale: centre
centre: centrale cette contre d'entre entre genre mettre montre rendre vendre vente
cependant: pendant
certain: certaine certaines certains terrain
certaine: certain certaines certains
certaines: certain certaine certains
certains: certain certaine certaines
cette: carte celle centre chute mettre perte petite reste texte vente
chacun: chaque
change: chaque charge
changement: 
chaque: chacun change charge
charge: carte change chaque large
chiffre: chiffres
chiffres: chiffre
choix: chose
chose: cause choix choses chute crise
choses: chose
chute: carte cause cette chose doute haute route toute
clair: 
classique: 
client: clients soient tient vient
clients: client
coeur: couleur cours court
collection: 
comme: comment compte femme forme gamme homme hommes somme sommes
comment: comme moment
commerce: 
commercial: 
commission: 
communication: 
compagnie: campagne
compris: comptes
compte: comme comptes
comptes: compris compte
concerne: 
concurrence: 
condition: conditions
conditions: condition
confiance: 
connu: bonne donne donné
conseil: 
conserver: 
consommation: 
constitue: continue
construction: 
continue: constitue
contraire: 
contrat: contre
contre: centre contrat entre montre notre outre votre
corps: cours
couleur: coeur couleurs
couleurs: couleur
coupon: 
courant: court durant pourtant
cours: bourse coeur corps court jours leurs
court: coeur courant cours jours
crise: cause chose prime prise
croissance: 
création: 
crédit: 
créer: 
culture: 
d'abord: 
d'achat: l'achat
d'actions: actions l'action
d'affaires: affaires
d'ailleurs: ailleurs
d'autant: autant
d'autres: autres l'autre
d'avoir: avoir savoir
d'entre: centre entre
d'entreprise: entreprise l'entreprise
d'une: donne doute jeune l'une qu'une
davantage: 
demande: 
depuis: 
dernier: derniers
derniers: dernier
devant: avant devenu devient devrait durant
devenir: devenu venir
devenu: devant devenir devient revenu revenus
devient: devant devenu devraient revient vient
devra: devrait
devraient: devient devrait
devrait: devant devra devraient serait
difficile: 
différence: différentes différents
différentes: différence différents
différents: différence différentes
directement: 
directeur: 
direction: 
dispose: 
distribution: 
divers: diverses tiers
diverses: divers
dividende: 
division: décision
doivent: soient souvent
dollar: dollars
dollars: dollar
domaine: semaine
donne: bonne bonnes connu d'une donner donné données doute monde
donner: bonne bonnes donne donné données
donné: bonne connu donne donner données
données: années bonnes donne donner donné
dossier: 
double: doute
doute: chute d'une donne double forte haute outre porte rouge route sorte toute toutes
droit: droits trois
droits: droit trois
durant: aurait autant courant devant quant
durée: 
début: 
décembre: 
décidé: 
décision: division
départ: 
désormais: 
développement: 
développer: 
effet: 
elles: belges belle celle celles telle
encore: entre
enfants: 
enfin: 
ensemble: l'ensemble semble
ensuite: suite
entendu: 
entre: autre centre contre d'entre encore genre mettre montre notre outre rendre titre vendre vente votre
entreprise: d'entreprise entreprises l'entreprise
entreprises: entreprise
environ: 
essentiellement: 
estime: 
etats-unis: 
europe: européen l'europe
européen: europe européenne européens
européenne: européen européennes européens
européennes: européenne européens
européens: européen européenne européennes
exemple: 
existe: liste
explique: 
express: 
faible: faire famille table taille
faire: cadre faible firme voire
famille: faible taille
faudra: 
femme: comme femmes firme forme gamme homme somme terme
femmes: femme hommes sommes termes
filiale: fiscale
finalement: 
financier: financiers
financiers: financier
firme: faire femme force forme forte terme
fiscale: filiale
flandre: 
fonction: 
fonds: monde poids
force: firme forme forte parce porte sorte
formation: 
forme: comme femme firme force formule forte homme porte somme sorte terme
formule: forme
forte: carte doute firme force forme perte porte route sorte toute
fortement: 
frais: franc francs train trois
franc: blanc frais france francs grand
france: franc francs grande
francs: frais franc france grands
février: 
gamme: comme femme homme somme
garantie: 
genre: centre entre guerre pense rendre terre vendre vente
gestion: question
gouvernement: 
grand: franc grande grandes grands prend quand
grande: france grand grandes grands
grandes: grand grande grands
grands: francs grand grande grandes
groupe: groupes rouge route trouve
groupes: groupe
guerre: genre pierre terre
général: générale
générale: général
généralement: 
hausse: aussi baisse cause haute passe
haute: autre carte cause chute doute hausse route toute
heures: jeunes leurs mesures
homme: comme femme forme gamme hommes l'homme somme sommes
hommes: comme femmes homme somme sommes
important: importante
importante: important
informations: 
informatique: 
international: internationale
internationale: international
internet: 
investissement: investissements
investissements: investissement
investisseurs: 
jacques: banques
jamais: 
janvier: 
japon: 
jeune: d'une jeunes l'une peine seule
jeunes: heures jeune
jouer: jours
jours: bourse cours court jouer leurs
juillet: 
jusqu: juste
jusqu'au: 
juste: jusqu justice liste reste suite
justice: juste
l'achat: d'achat
l'action: action d'actions
l'aide: 
l'année: année
l'argent: 
l'art: 
l'autre: autre d'autres
l'avenir: 
l'eau: l'etat
l'emploi: 
l'ensemble: ensemble
l'entreprise: d'entreprise entreprise
l'etat: l'eau
l'europe: europe
l'exercice: 
l'heure: 
l'homme: homme
l'image: 
l'indice: 
l'industrie: 
l'investisseur: 
l'objet: 
l'occasion: 
l'ordre: 
l'une: d'une jeune ligne qu'une
l'union: 
l'économie: 
l'époque: 
l'étranger: 
l'évolution: 
lancer: lancé
lancé: blanc lancer santé
laquelle: 
large: carte charge parce parle
largement: 
lequel: 
leurs: cours heures jours valeurs
ligne: l'une liste livre
liste: existe juste ligne livre reste
livre: ligne liste suivre titre
logiciel: 
londres: 
longtemps: 
longue: 
lorsque: 
luxembourg: 
maintenant: 
maison: raison raisons
majorité: 
malgré: 
management: 
manque: banque banques marque
marché: marchés
marchés: marché
marketing: 
marque: banque manque
matériel: 
maximum: minimum
meilleur: meilleure
meilleure: meilleur
membres: mesures
mesure: mesures mettre
mesures: heures membres mesure
mettre: centre cette entre mesure montre
michel: 
microsoft: 
mieux: 
milieu: 
milliard: milliards
milliards: milliard
millions: 
minimum: maximum
ministre: 
moindre: monde montre
moins: moyens poids point points
moitié: 
moment: comment moyen moyens soient
monde: bonne donne fonds moindre montre
mondial: mondiale
mondiale: mondial
monnaie: 
montant: 
montre: centre contre entre mettre moindre monde notre outre votre
monétaire: 
mouvement: 
moyen: moment moyenne moyens
moyenne: moyen moyens
moyens: moins moment moyen moyenne
musique: unique
mémoire: 
n'est: c'est n'ont s'est
n'ont: n'est
n'était: était
nature: notre
nettement: 
niveau: nouveau
nombre: nombreux notre novembre
nombreuses: 
nombreux: nombre
notamment: 
notre: autre contre entre montre nature nombre outre titre voire votre
nouveau: niveau nouveaux nouvel
nouveaux: nouveau
nouvel: nouveau nouvelle
nouvelle: nouvel nouvelles
nouvelles: nouvelle
novembre: nombre
numéro: 
néanmoins: 
nécessaire: 
objectif: 
obligations: 
octobre: 
oeuvre: outre
offre: outre
opération: opérations
opérations: opération
outre: autre autres contre doute entre montre notre oeuvre offre quatre route titre toute votre
pages: paris payer
papier: parler passer payer
parce: carte force large paris parle parler parmi parti partie passe perte place porte
parents: 
parfaitement: 
parfois: paris
paris: pages parce parfois parle parmi parti partie partir permis prise
parle: carte large parce paris parler parmi parti partie passe perte porte salle table
parler: papier parce parle partir passer payer
parmi: parce paris parle parti partie partir permis
partenaires: 
parti: carte parce paris parle parmi partie partir perte porte
participation: 
particulier: 
partie: carte parce paris parle parmi parti partir perte porte
partir: paris parler parmi parti partie
passage: passe
passe: assez baisse cause hausse parce parle passage passer passé pense presse prise
passer: assez papier parler passe passé payer
passé: passe passer
patron: 
payer: pages papier parler passer
pays-bas: 
peine: jeune pense perte petite plein point prime prise
pendant: cependant
pense: genre passe peine perte presse prise vente
perdu: perte
performances: 
permet: permis perte terme termes
permettent: 
permettre: 
permis: paris parmi permet termes
personne: personnel personnes
personnel: personne personnes
personnes: personne personnel
perspectives: 
perte: carte cette forte parce parle parti partie peine pense perdu permet petite pierre porte reste sorte terme terre texte vente
petit: petite petites petits
petite: cette peine perte petit petites petits
petites: petit petite petits
petits: petit petite petites
peuvent: souvent
philippe: 
pierre: guerre perte terre
place: parce
placement: 
plein: peine
plupart: 
plusieurs: 
poids: fonds moins point points
point: moins peine poids points soient
points: moins poids point
politique: politiques
politiques: politique
population: 
porte: carte doute force forme forte parce parle parti partie perte route sorte toute
portefeuille: 
position: 
possibilité: possibilités
possibilités: possibilité
possible: 
potentiel: 
pourquoi: 
pourra: pourrait
pourraient: pourrait
pourrait: pourra pourraient pourtant
pourtant: courant pourrait
pouvoir: 
pratique: 
premier: premiers
premiers: premier
prend: grand prendre
prendre: prend rendre vendre
presque: presse puisque risque
presse: passe pense presque preuve prise reste
pression: 
preuve: presse trouve
prime: crise peine prise
principal: principe
principe: principal
prise: crise paris passe peine pense presse prime précise reprise
processus: 
prochain: 
proche: propre
production: protection réduction
produit: produits
produits: produit
professionnels: 
programme: programmes
programmes: programme
progression: 
projet: projets
projets: projet
propos: propose propre propres
propose: propos propre
propre: proche propos propose propres
propres: propos propre
protection: production
précise: prise
présence: présent présente
présent: présence présente président
présente: présence présent représente
président: présent
prévisions: 
prévoit: 
prévu: 
public: publics
publicité: 
publics: public
publique: 
puisque: presque risque
période: 
qu'elle: qu'elles
qu'elles: qu'elle
qu'en: qu'il qu'on qu'un qu'une
qu'il: qu'en qu'ils qu'on qu'un
qu'ils: qu'il
qu'on: qu'en qu'il qu'un qu'une
qu'un: aucun qu'en qu'il qu'on qu'une
qu'une: aucune d'une l'une qu'en qu'on qu'un
qualité: réalité
quand: grand quant
quant: autant avant ayant durant quand étant
quatre: autre outre
quelque: quelques
quelques: quelque
question: gestion questions
questions: question
raison: maison raisons
raisons: maison raison
rapide: 
rapidement: 
rapport: 
recherche: 
relativement: 
rendement: 
rendre: centre entre genre prendre vendre
reprise: prise
représente: présente
responsable: responsables
responsables: responsable
reste: cette juste liste perte presse restent rester route texte vente
restent: reste rester revient
rester: reste restent
retour: autour
retrouve: trouve
revanche: 
revenu: devenu revenus revient
revenus: devenu revenu
revient: devient restent revenu vient
risque: presque puisque risques
risques: risque
rouge: doute groupe route toute trouve
route: chute doute forte groupe haute outre porte reste rouge sorte toute toutes trouve
réaliser: réalisé
réalisé: réaliser réalité
réalité: qualité réalisé
récemment: 
réduction: production
réduire: 
référence: 
régime: région
région: régime
réseau: réseaux
réseaux: réseau
résultat: résultats
résultats: résultat
s'agit: 
s'est: c'est n'est
salle: belle celle parle seule style table taille telle ville
santé: lancé
savoir: avoir d'avoir
second: seconde selon seront
seconde: second
secteur: secteurs
secteurs: secteur
selon: second seront
semaine: domaine semaines
semaines: semaine
semble: ensemble seule simple
semestre: 
septembre: 
serait: aurait devrait seront
seront: second selon serait
service: services
services: service
seule: belle celle jeune salle semble style telle
seulement: 
signifie: 
simple: semble
simplement: 
situation: 
situe: suite titre
social: sociale
sociale: social
société: sociétés
sociétés: société
soient: client doivent moment point souvent tient vient
solution: 
somme: comme femme forme gamme homme hommes sommes sorte
sommes: comme femmes homme hommes somme
sorte: carte doute force forme forte perte porte route somme suite série toute
souvent: doivent peuvent soient
stratégie: 
structure: 
style: salle seule
suffit: 
suite: ensuite juste situe sorte suivre
suivre: livre suite
sujet: 
supérieur: 
surtout: 
sécurité: 
série: sorte
table: faible parle salle tableau taille telle
tableau: table
taille: faible famille salle table telle ville
tandis: 
technique: techniques
techniques: technique
technologie: 
telle: belge belle celle celles elles salle seule table taille terme terre texte ville
temps: termes
tendance: 
tenir: venir
terme: femme firme forme permet perte telle termes terre texte
termes: femmes permet permis temps terme terre
terrain: certain train
terre: genre guerre perte pierre telle terme termes texte titre
texte: cette perte reste telle terme terre toute vente
tient: biens client soient tiers vient étaient
tiers: biens divers tient titre titres
titre: autre entre livre notre outre situe terre tiers titres votre
titres: autres tiers titre
total: 
totalement: 
toujours: 
toute: chute doute forte haute outre porte rouge route sorte texte toutes trouve
toutefois: 
toutes: doute route toute
train: frais terrain trois
traitement: 
travail: travaux
travailler: travailleurs
travailleurs: travailler
travaux: travail
travers: 
trimestre: 
trois: droit droits frais train
trouve: groupe preuve retrouve rouge route toute trouver
trouver: trouve
téléphone: 
unique: musique
uniquement: 
valeur: valeurs
valeurs: leurs valeur
vendre: centre entre genre prendre rendre venir vente
venir: devenir tenir vendre vente
vente: centre cette entre genre pense perte reste texte vendre venir ventes vient
ventes: vente
version: 
viennent: 
vient: avaient biens client devient revient soient tient vente
ville: belle celle salle taille telle
vitesse: 
voire: avoir faire notre voiture votre
voiture: voire voitures votre
voitures: voiture
volume: 
votre: autre contre entre montre notre outre titre voire voiture
vraiment: 
véritable: 
wallonie: wallonne
wallonne: wallonie
windows: 
économique: économiques
économiques: économique
également: 
électronique: 
élevé: 
éléments: 
étaient: avaient tient était étant
était: avait n'était étaient étant
étant: autant avant ayant quant étaient était
étrangers: 
études: 
évidemment: 
éviter: 

