accord: encore second
acheter: 
actifs: action actions actuel autres petits
action: actifs actions actuel d'actions fonction gestion l'action patron région
actionnaires: 
actions: actifs action d'actions l'action
activité: activités
activités: activité autorités
actuel: actifs action actuelle autres jacques lequel
actuelle: actuel laquelle
actuellement: 
affaires: d'affaires
affiche: 
ailleurs: couleurs d'ailleurs meilleur meilleure valeurs
allemagne: 
américain: américaine
américaine: américain
analystes: 
années: autres banques bonnes données l'année ventes
atteindre: atteint
atteint: atteindre autant
aucune: autant qu'une
aujourd'hui: 
aurait: autant courant devrait durant pourrait serait suffit
autant: atteint aucune aurait autour autres courant d'autant devant durant montant pourtant
autorités: activités
autour: autant autres retour surtout
autres: actifs actuel années autant autour d'autres heures l'autre quatre titres toutes
avaient: client devient devraient revient soient vraiment étaient
baisse: banque bourse existe faible hausse maison passer presse raison taille
banque: baisse banques chaque jacques longue manque marque risque unique
banques: années banque bonnes jacques manque marque risques
beaucoup: 
belgacom: 
belges: bonnes budget celles femmes heures jeunes termes ventes
belgique: 
besoin: gestion
bonnes: années banques belges donner données hommes jeunes londres points sommes toutes ventes
bourse: baisse double hausse pourra
bruxelles: nouvelles qu'elles
budget: belges
bureau: niveau nouveau réseau
bénéfice: bénéfices
bénéfices: bénéfice
bénéficiaire: 
campagne: compagnie
capacité: 
capital: 
celle-ci: celles celui-ci
celles: belges celle-ci choses femmes heures jeunes qu'elles termes ventes
celui-ci: celle-ci
centrale: centre contraire contrat contre générale
centre: centrale contrat contre culture d'entre encore mesure mettre montre oeuvre prendre quatre rendre vendre ventes
cependant: pendant
certain: certaine certaines certains serait terrain
certaine: certain certaines certains semaine terrain
certaines: certain certaine certains semaines
certains: certain certaine certaines terrain
chacun: change chaque charge
change: chacun chaque charge france grande
changement: largement management
chaque: banque chacun change charge manque marque risque unique
charge: chacun change chaque
chiffre: chiffres
chiffres: chiffre
choses: celles hommes
classique: 
client: avaient clients comment devient doivent moment revient soient étaient
clients: client parents points soient éléments
collection: 
comment: client commerce courant doivent hommes moment notamment récemment soient sommes souvent
commerce: comment commercial concerne
commercial: commerce
commission: 
communication: 
compagnie: campagne
compris: compte comptes
compte: compris comptes contre coupon nombre simple
comptes: compris compte hommes sommes toutes
concerne: commerce conserver contre
concurrence: 
condition: conditions fonction position
conditions: condition
confiance: continue
conseil: 
conserver: concerne
consommation: 
constitue: continue
construction: 
continue: confiance constitue contre
contraire: centrale contrat contre monétaire
contrat: centrale centre contraire contre courant montant montre
contre: centrale centre compte concerne continue contraire contrat culture d'entre londres longue mettre moindre montre nombre quatre rendre vendre voiture
couleur: couleurs culture valeur
couleurs: ailleurs couleur culture toujours valeurs
coupon: compte courant
courant: aurait autant comment contrat coupon durant montant pourrait pourtant souvent
croissance: 
création: formation opération région
crédit: produit prévoit
culture: centre contre couleur couleurs nature quatre voiture
d'abord: d'avoir
d'achat: d'autant l'achat
d'actions: action actions l'action
d'affaires: affaires
d'ailleurs: ailleurs
d'autant: autant d'achat d'autres durant
d'autres: autres d'autant d'entre l'autre
d'avoir: d'abord l'avenir pouvoir savoir
d'entre: centre contre d'autres l'autre mettre montre prendre rendre vendre
d'entreprise: entreprise entreprises l'entreprise
davantage: 
demande: devant domaine grande seconde semaine
depuis: permis reprise
dernier: derniers devenir donner dossier
derniers: dernier
devant: autant demande devenir devenu devient devraient devrait doivent durant départ pendant peuvent revenu revient serait seront
devenir: dernier devant devenu devient devrait l'avenir revenu revenus
devenu: devant devenir devient divers doivent niveau peuvent revenu revenus revient
devient: avaient client devant devenir devenu devraient devrait doivent peuvent restent revenu revient soient étaient
devraient: avaient devant devient devrait revient vraiment
devrait: aurait devant devenir devient devraient durant serait terrain
difficile: 
différence: différentes différents référence
différentes: différence différents
différents: différence différentes
directement: 
directeur: direction secteur
direction: directeur
dispose: propose
distribution: 
divers: devenu diverses doivent niveau travers
diverses: divers
dividende: 
division: décision
doivent: client comment devant devenu devient divers moment peuvent soient souvent
dollar: dollars donner
dollars: dollar
domaine: demande semaine semaines
donner: bonnes dernier dollar données dossier lancer
données: années bonnes donner londres
dossier: dernier donner passer
double: bourse faible nombre semble
droits: petits points produits projets propos
durant: aurait autant courant d'autant devant devrait départ pourtant serait seront
décembre: novembre
décidé: 
décision: division
départ: devant durant plupart
désormais: 
développement: 
développer: 
encore: accord centre europe rendre vendre
enfants: pendant
ensemble: exemple l'ensemble semble
ensuite: estime
entendu: 
entreprise: d'entreprise entreprises l'entreprise reprise
entreprises: d'entreprise entreprise l'entreprise
environ: 
essentiellement: 
estime: ensuite gestion justice petite régime
etats-unis: 
europe: encore européen européens groupe l'europe propre
européen: europe européenne européennes européens
européenne: européen européennes européens
européennes: européen européenne européens
européens: europe européen européenne européennes
exemple: ensemble semble simple
existe: baisse petite
explique: publique
express: presse
faible: baisse double famille filiale semble taille
famille: faible filiale taille
faudra: flandre pourra
femmes: belges celles heures hommes jeunes membres permet permis sommes termes ventes
filiale: faible famille fiscale sociale
finalement: management simplement totalement également
financier: financiers
financiers: financier
fiscale: filiale
flandre: faudra france grande londres moindre prendre rendre vendre
fonction: action condition formation l'action position solution
formation: création fonction informations
formule: 
fortement: largement mouvement nettement
france: change flandre francs grande grandes grands lancer
francs: france grande grandes grands
février: éviter
garantie: grande partie
gestion: action besoin estime position pression question questions version
gouvernement: 
grande: change demande flandre france francs garantie grandes grands groupe l'aide prendre rapide rendre
grandes: france francs grande grands groupes tandis
grands: france francs grande grandes tandis
groupe: europe grande groupes preuve proche propre trouve trouver
groupes: grandes groupe propos propres toutes trouve trouver
guerre: pierre quatre suivre
général: générale
générale: centrale général
généralement: 
hausse: baisse bourse passer presse
heures: autres belges celles femmes hommes jeunes l'heure membres mesure mesures oeuvre termes titres toutes ventes études
hommes: bonnes choses comment comptes femmes heures l'homme sommes termes toutes
important: importante montant pourtant
importante: important
informations: formation informatique
informatique: informations
international: internationale
internationale: international
internet: 
investissement: investissements
investissements: investissement
investisseurs: l'investisseur
jacques: actuel banque banques manque marque risques
jamais: tandis
janvier: lancer papier
jeunes: belges bonnes celles femmes heures mesures termes toutes ventes études
juillet: taille
jusqu'au: 
justice: estime
l'achat: d'achat l'etat
l'action: action actions d'actions fonction l'union
l'aide: grande l'année l'autre l'ordre rapide
l'année: années l'aide l'autre
l'argent: largement
l'autre: autres d'autres d'entre l'aide l'année l'heure l'ordre quatre
l'avenir: d'avoir devenir
l'emploi: 
l'ensemble: ensemble
l'entreprise: d'entreprise entreprise entreprises
l'etat: l'achat n'était
l'europe: europe l'heure
l'exercice: 
l'heure: heures l'autre l'europe l'homme l'ordre
l'homme: hommes l'heure
l'image: 
l'indice: 
l'industrie: 
l'investisseur: investisseurs
l'objet: projet
l'occasion: 
l'ordre: l'aide l'autre l'heure londres
l'union: l'action
l'économie: 
l'époque: 
l'étranger: étrangers
l'évolution: 
lancer: donner france janvier papier parler passer
laquelle: actuelle lequel qu'elle
largement: changement fortement l'argent management placement
lequel: actuel laquelle
logiciel: 
londres: bonnes contre données flandre l'ordre longue moindre montre rendre vendre
longtemps: 
longue: banque contre londres lorsque manque montre
lorsque: longue marque presque puisque risque
luxembourg: 
maintenant: 
maison: baisse patron raison raisons
majorité: 
malgré: marché
management: changement finalement largement
manque: banque banques chaque jacques longue marque montre musique risque unique
marché: malgré marchés marque
marchés: marché
marketing: 
marque: banque banques chaque jacques lorsque manque marché musique partie risque unique
matériel: 
maximum: minimum
meilleur: ailleurs meilleure milieu
meilleure: ailleurs meilleur
membres: femmes heures mesure mesures mettre nombre semble
mesure: centre heures membres mesures mettre montre nature oeuvre rendre semestre vendre
mesures: heures jeunes membres mesure mettre
mettre: centre contre d'entre membres mesure mesures montre nature oeuvre permettre petite quatre rendre semestre vendre
michel: milieu
microsoft: 
milieu: meilleur michel minimum
milliard: milliards millions
milliards: milliard millions
millions: milliard milliards
minimum: maximum milieu
ministre: montre
moindre: contre flandre londres monnaie montre prendre rendre vendre voiture
moitié: montre
moment: client comment doivent montant mouvement moyenne moyens soient souvent
mondial: mondiale social
mondiale: mondial monnaie sociale
monnaie: moindre mondiale montant montre monétaire
montant: autant contrat courant important moment monnaie montre pendant pourtant
montre: centre contrat contre d'entre londres longue manque mesure mettre ministre moindre moitié monnaie montant monétaire nombre quatre rendre vendre voiture
monétaire: contraire monnaie montre
mouvement: fortement moment seulement souvent
moyenne: moment moyens
moyens: moment moyenne soient
musique: manque marque publique puisque quelque risque unique
mémoire: réduire
n'était: l'etat
nature: culture mesure mettre nombre quatre voiture
nettement: fortement notamment rendement seulement
niveau: bureau devenu divers nouveau nouveaux revenu réseau
nombre: compte contre double membres montre nature nombreux novembre numéro semble
nombreuses: nombreux
nombreux: nombre nombreuses
notamment: comment nettement totalement
nouveau: bureau niveau nouveaux nouvel nouvelle souvent
nouveaux: niveau nouveau nouvel nouvelle
nouvel: nouveau nouveaux nouvelle nouvelles souvent toutes trouve trouver
nouvelle: nouveau nouveaux nouvel nouvelles qu'elle
nouvelles: bruxelles nouvel nouvelle qu'elles
novembre: décembre nombre
numéro: nombre
néanmoins: 
nécessaire: 
objectif: 
obligations: 
octobre: 
oeuvre: centre heures mesure mettre preuve rendre suivre vendre
opération: création opérations population
opérations: opération
papier: janvier lancer parler partie partir passer premier rapide
parents: clients parfois points
parfaitement: traitement
parfois: parents partie partir permis
parler: lancer papier partie partir passer permet valeur
partenaires: 
participation: 
particulier: 
partie: garantie marque papier parfois parler partir permis petite
partir: papier parfois parler partie passer permis savoir
passage: passer
passer: baisse dossier hausse lancer papier parler partir passage presse rester
patron: action maison raison
pays-bas: 
pendant: cependant devant enfants montant peuvent tendance
performances: 
permet: femmes parler permettre permis peuvent pierre projet serait seront termes
permettent: permettre
permettre: mettre permet permettent semestre
permis: depuis femmes parfois partie partir permet petits serait termes
personne: personnel personnes
personnel: personne personnes
personnes: personne personnel
perspectives: 
petite: estime existe mettre partie petites petits
petites: petite petits titres ventes
petits: actifs droits permis petite petites points
peuvent: devant devenu devient doivent pendant permet preuve présent restent revenu revient souvent
philippe: 
pierre: guerre permet pourra prendre presse preuve propre
placement: largement également
plupart: départ
plusieurs: 
points: bonnes clients droits parents petits projets soient
politique: politiques pratique
politiques: politique
population: opération
portefeuille: 
position: condition fonction gestion solution
possibilité: possibilités
possibilités: possibilité
possible: 
potentiel: 
pourquoi: 
pourra: bourse faudra pierre pourrait pourtant
pourraient: pourrait pourtant
pourrait: aurait courant pourra pourraient pourtant
pourtant: autant courant durant important montant pourra pourraient pourrait
pouvoir: d'avoir prévoit savoir
pratique: politique presque publique
premier: papier premiers presse preuve rester
premiers: premier
prendre: centre d'entre flandre grande moindre pierre presque presse preuve propre rendre vendre
presque: lorsque pratique prendre presse preuve puisque quelque risque risques
presse: baisse express hausse passer pierre premier prendre presque pression preuve proche propose propre précise rester vitesse
pression: gestion presse progression question version
preuve: groupe oeuvre peuvent pierre premier prendre presque presse proche propre trouve trouver
principal: principe
principe: principal précise
processus: 
prochain: proche
proche: groupe presse preuve prochain projet propos propose propre propres précise trouve
production: protection réduction
produit: crédit produits projet prévoit
produits: droits produit projets
professionnels: 
programme: programmes
programmes: programme
progression: pression
projet: l'objet permet proche produit projets propos propre propres présent
projets: droits points produits projet propos propres
propos: droits groupes proche projet projets propose propre propres
propose: dispose presse proche propos propre propres précise
propre: europe groupe pierre prendre presse preuve proche projet propos propose propres trouve
propres: groupes proche projet projets propos propose propre
protection: production
précise: presse principe proche propose régime
présence: présent présente représente
présent: peuvent projet présence présente président prévoit représente restent réseau
présente: présence présent président représente
président: présent présente
prévisions: 
prévoit: crédit pouvoir produit présent
public: publicité publics publique
publicité: public publics
publics: public publicité publique
publique: explique musique pratique public publics puisque quelque unique
puisque: lorsque musique presque publique quelque risque risques unique
période: 
qu'elle: laquelle nouvelle qu'elles qu'ils qu'une quelque
qu'elles: bruxelles celles nouvelles qu'elle qu'ils quelques
qu'ils: qu'elle qu'elles qu'une
qu'une: aucune qu'elle qu'ils quatre
qualité: réalisé réalité
quatre: autres centre contre culture guerre l'autre mettre montre nature qu'une suivre
quelque: musique presque publique puisque qu'elle quelques unique
quelques: qu'elles quelque
question: gestion pression questions
questions: gestion question
raison: baisse maison patron raisons région
raisons: maison raison
rapide: grande l'aide papier reprise régime
rapidement: rendement traitement
rapport: 
recherche: 
relativement: 
rendement: nettement rapidement seulement
rendre: centre contre d'entre encore flandre grande londres mesure mettre moindre montre oeuvre prendre vendre
reprise: depuis entreprise rapide
représente: présence présent présente
responsable: responsables
responsables: responsable
restent: devient peuvent présent rester revenu revient
rester: passer premier presse restent retour secteur ventes éviter
retour: autour rester retrouve secteur
retrouve: retour trouve trouver
revanche: 
revenu: devant devenir devenu devient niveau peuvent restent revenus revient réseau
revenus: devenir devenu revenu revient
revient: avaient client devant devenu devient devraient peuvent restent revenu revenus soient étaient
risque: banque chaque lorsque manque marque musique presque puisque risques unique
risques: banques jacques presque puisque risque
réaliser: réalisé réalité
réalisé: qualité réaliser réalité
réalité: qualité réaliser réalisé
récemment: comment
réduction: production
réduire: mémoire régime
référence: différence
régime: estime précise rapide réduire région
région: action création raison régime
réseau: bureau niveau présent revenu réseaux
réseaux: réseau
résultat: résultats
résultats: résultat
s'agit: serait suffit
savoir: d'avoir partir pouvoir
second: accord seconde seront
seconde: demande second seront
secteur: directeur rester retour secteurs
secteurs: secteur
semaine: certaine demande domaine semaines semble serait service
semaines: certaines domaine semaine services
semble: double ensemble exemple faible membres nombre semaine simple
semestre: mesure mettre permettre trimestre
septembre: 
serait: aurait certain devant devrait durant permet permis s'agit semaine seront service suffit terrain
seront: devant durant permet second seconde serait soient surtout
service: semaine serait services
services: semaines service
seulement: mouvement nettement rendement simplement également
signifie: 
simple: compte exemple semble
simplement: finalement seulement
situation: solution
social: mondial sociale société
sociale: filiale mondiale social société
société: social sociale sociétés
sociétés: société
soient: avaient client clients comment devient doivent moment moyens points revient seront souvent étaient
solution: fonction position situation
sommes: bonnes comment comptes femmes hommes termes toutes
souvent: comment courant doivent moment mouvement nouveau nouvel peuvent soient
stratégie: 
structure: 
suffit: aurait s'agit serait
suivre: guerre oeuvre quatre
supérieur: 
surtout: autour seront
sécurité: 
tableau: 
taille: baisse faible famille juillet
tandis: grandes grands jamais
technique: techniques
techniques: technique
technologie: 
tendance: pendant
termes: belges celles femmes heures hommes jeunes permet permis sommes titres toutes ventes
terrain: certain certaine certains devrait serait
titres: autres heures petites termes toutes voitures
totalement: finalement notamment également
toujours: couleurs
toutefois: toutes
toutes: autres bonnes comptes groupes heures hommes jeunes nouvel sommes termes titres toutefois trouve trouver ventes études
traitement: parfaitement rapidement vraiment
travail: travailler travaux travers
travailler: travail travailleurs
travailleurs: travailler
travaux: travail travers
travers: divers travail travaux trouver étrangers
trimestre: semestre
trouve: groupe groupes nouvel preuve proche propre retrouve toutes trouver
trouver: groupe groupes nouvel preuve retrouve toutes travers trouve
téléphone: 
unique: banque chaque manque marque musique publique puisque quelque risque
uniquement: 
valeur: couleur parler valeurs
valeurs: ailleurs couleurs valeur
vendre: centre contre d'entre encore flandre londres mesure mettre moindre montre oeuvre prendre rendre ventes
ventes: années belges bonnes celles centre femmes heures jeunes petites rester termes toutes vendre
version: gestion pression
viennent: 
vitesse: presse
voiture: contre culture moindre montre nature voitures volume
voitures: titres voiture
volume: voiture
vraiment: avaient devraient traitement étaient
véritable: 
wallonie: wallonne
wallonne: wallonie
windows: 
économique: économiques
économiques: économique
également: finalement placement seulement totalement
électronique: 
éléments: clients
étaient: avaient client devient revient soient vraiment
étrangers: l'étranger travers
études: heures jeunes toutes
évidemment: 
éviter: février rester

