ability: 
about: above amount
above: about
access: across
according: 
account: amount
across: access
action: 
added: asked ended
addition: additional
additional: addition
address: 
administration: 
after: later offer often water
again: against
against: again
agency: 
agreed: 
agreement: 
allow: allows below
allows: allow
almost: 
along: among
already: 
although: though
always: 
america: american
american: america
among: along amount
amount: about account among around
analysis: analyst analysts
analyst: analysis analysts
analysts: analysis analyst
announced: 
annual: 
another: other
apple: 
application: applications
applications: application
approach: 
april: 
areas: great press
around: amount found
asked: added based
assets: 
association: 
august: 
authorities: 
available: 
average: 
banks: basis bonds talks wants
based: asked basis cases named
basis: banks based cases
became: because become
because: became
become: became before income
before: become
began: begin reagan
begin: began behind being
behind: begin being
being: begin behind buying doing going thing using
believe: 
below: allow
better: 
between: 
billion: million
black: place
board: toward
bonds: banks funds pounds
british: 
budget: 
building: 
built: 
business: businesses
businesses: business
buying: being during saying trying using
calif: calls
california: 
called: calls killed
calls: calif called cases sales talks
campaign: 
can't: cannot don't isn't won't
cannot: can't
capabilities: 
capital: 
cases: based basis calls comes costs james makes rates sales takes
central: control general
cents: costs tests wants
certain: 
chairman: 
change: changes charge charges exchange range
changes: change charge charges
charge: change changes charges large share
charges: change changes charge shares
chief: 
children: 
claims: 
clear: nuclear
close: closed those whose
closed: close
color: 
comes: cases costs james times women
command: comment common company
comment: command common
commercial: 
commission: 
committee: 
common: command comment
communications: 
companies: company's
company: command company's
company's: companies company
compared: 
complete: complex
complex: complete
computer: computers
computers: computer
concern: 
conditions: 
conference: 
congress: 
considered: 
continue: continued
continued: continue
contract: 
control: central
corporate: 
costs: cases cents comes tests
could: court found should world would
countries: 
country: 
course: court hours house source
court: could course hours
create: created great
created: create
credit: 
current: currently
currently: current
customers: 
database: 
david: 
death: health
december: 
decided: declined
decision: 
declined: decided
defense: 
demand: 
democratic: 
department: 
described: 
design: designed
designed: design
develop: developed
developed: develop
development: 
didn't: don't isn't
different: 
difficult: 
directly: director
director: directly
discussed: 
display: 
distribution: 
document: 
doesn't: don't
doing: being during going point thing using
dollar: dollars
dollars: dollar
don't: can't didn't doesn't isn't won't
drive: drives price
drives: drive prices
during: buying doing using
earlier: 
early: nearly party really
earnings: 
economic: economy
economy: economic
effect: effort expect
effort: effect efforts
efforts: effort
eight: light might night right rights
either: higher other rather
employees: 
ended: added index needed under
energy: every
enough: though
environment: 
equipment: 
especially: 
estimated: 
europe: european
european: europe
every: energy never
example: 
exchange: change
executive: 
existing: 
expect: effect expected expects
expected: expect expects
expects: expect expected
family: 
feature: features future
features: feature futures
federal: general several
field: filed
figures: futures
filed: field files killed miles
files: filed firms lines miles rules sales times
final: fiscal
financial: 
firms: files first terms
first: firms
fiscal: final
following: 
force: forces former source
forces: force former sources
foreign: 
former: force forces order
found: around could funds pounds would
french: 
friday: 
function: functions
functions: function
funds: bonds found pounds
further: 
future: feature futures
futures: features figures future
general: central federal several
german: germany
germany: german
getting: meeting
given: seven
going: being doing growing point thing using
government: 
graphics: 
great: areas create
group: groups
groups: group troops
growing: going
growth: 
hardware: 
having: making saying taking
health: death
higher: either
hours: course court house
house: course hours those whose
however: 
image: 
important: 
include: included includes
included: include includes
includes: include included
including: 
income: become
increase: increased
increased: increase
index: ended under
industrial: 
industry: 
inflation: 
information: 
insurance: 
interest: 
interface: 
international: 
investigation: 
investment: 
investors: 
involved: 
isn't: can't didn't don't won't
issue: issues
issues: issue
itself: 
james: cases comes makes named rates sales takes times
january: 
japan: 
japanese: 
killed: called filed
known: shown
language: 
large: charge largest range
largest: large latest
later: after latest leader lower paper rates rather water
latest: largest later rates
leader: later leaders
leaders: leader
leading: trading
least: 
level: levels never seven
levels: level
light: eight might night right rights
likely: 
limited: 
lines: files miles times
little: 
local: total
london: 
longer: lower
looking: working
losses: 
lower: later longer power
machine: machines
machines: machine
macintosh: 
major: 
makes: cases james market markets miles rates sales taken takes
making: having saying taking
management: 
manager: managers
managers: manager
march: 
market: makes markets
marketing: 
markets: makes market
means: plans years
meeting: getting
member: members number
members: member numbers
memory: 
method: 
microsoft: 
might: eight light night right rights
miles: filed files lines makes rules sales times
military: 
million: billion
model: models money
models: model
monday: money sunday today
money: model monday month
month: money months north south
months: month
multiple: 
named: based james
nation's: national
national: nation's
nearly: early really
necessary: 
needed: ended needs
needs: needed seems weeks
network: networks
networks: network
never: every level server seven
night: eight light might right rights
north: month south
november: 
nuclear: clear
number: member numbers
numbers: members number
october: 
offer: after offered offers officer often order other
offered: offer offers
offering: 
offers: offer offered others
office: officer
officer: offer office
official: officials
officials: official
often: after offer
operating: operation operations
operation: operating operations
operations: operating operation
options: 
order: former offer other under
other: another either offer order others rather their there
others: offers other there
output: 
outside: 
package: 
paper: later power water
particularly: 
parts: party wants
party: early parts
people: 
percent: recent
performance: 
period: 
personal: 
place: black plans plant police price space
planned: 
plans: means place plant
plant: place plans point
point: doing going plant points
points: point pounds
police: place policy price
policy: police
political: 
position: 
possible: 
potential: 
pounds: bonds found funds points
power: lower paper
present: presented president recent
presented: present
president: present
press: areas process
pressure: 
previous: 
price: drive place police priced prices
priced: price prices
prices: drives price priced process
printer: 
private: 
probably: 
problem: problems
problems: problem
process: press prices processor
processing: 
processor: process
produce: product products reduce
product: produce products project
production: 
products: produce product
profit: profits
profits: profit
program: programs
programming: 
programs: program
project: product
proposal: proposed
proposed: proposal
provide: provided provides
provided: provide provides
provides: provide provided
public: 
purchase: 
quality: 
quarter: 
question: 
range: change large
rates: cases james later latest makes rather rules sales states takes water
rather: either later other rates water
reached: 
reagan: began reason
really: early nearly
reason: reagan
received: 
recent: percent present recently
recently: recent
record: report second
reduce: produce
release: released
released: release
remain: 
report: record reported reports
reported: report reports
reports: report reported
require: required requires
required: require requires
requirements: 
requires: require required
research: 
response: 
result: results
results: result
return: 
revenue: 
review: 
right: eight light might night rights
rights: eight light might night right
robert: 
rules: files miles rates sales
running: 
sales: calls cases files james makes miles rates rules shares states takes talks
saturday: 
saying: buying having making taking trying
scheduled: 
school: 
screen: street
second: record
securities: 
security: 
seems: needs terms weeks
selling: 
senate: state
senior: 
separate: 
september: 
series: server services
server: never series seven
service: services
services: series service
seven: given level never server
several: federal general
share: charge shares short space start state there where
shares: charges sales share states
short: share shown shows start
should: could showed would
showed: should shown shows
shown: known short showed shows
shows: short showed shown
significant: 
similar: 
simple: single
since: single space
single: simple since
small: still
software: 
something: 
source: course force sources
sources: forces source
south: month north
soviet: 
space: place share since state
special: 
specific: 
speed: 
spending: 
spokesman: 
staff: start state
standard: standards
standards: standard
start: share short staff started state
started: start state states
state: senate share space staff start started states
statement: 
states: rates sales shares started state takes
still: small
stock: stocks
stocks: stock
storage: 
strategy: 
street: screen
strong: 
structure: 
students: 
study: 
sunday: monday
supply: 
support: supports
supports: support
system: systems
systems: system
taken: makes takes taking
takes: cases james makes rates sales states taken talks times
taking: having making saying taken thing trading trying
talks: banks calls sales takes
technical: 
technology: 
telephone: 
television: 
terms: firms seems tests texas
tests: cents costs terms texas
texas: terms tests
their: other there these third
there: other others share their these third those three where
these: their there those three where whose
thing: being doing going taking things think third trying using
things: thing think
think: thing things third
third: their there thing think
those: close house there these three whose
though: although enough thought through
thought: though through
three: there these those
through: though thought
thursday: tuesday
times: comes files james lines miles takes
today: monday total
together: 
tools: troops
total: local today trial
toward: board
trade: 
trading: leading taking training trying
training: trading
trial: total
troops: groups tools
trying: buying saying taking thing trading
tuesday: thursday
turned: 
under: ended index order
union: units
united: units
units: union united
university: 
until: 
users: 
using: being buying doing during going thing
value: volume
various: 
vendors: 
version: 
video: 
volume: value
wanted: wants water
wants: banks cents parts wanted
washington: 
water: after later paper rates rather wanted
wednesday: 
weeks: needs seems works
where: share there these while white whose
whether: 
which: while white
while: where which white whose
white: where which while whose
whose: close house these those where while white
windows: 
within: 
without: 
women: comes
won't: can't don't isn't
workers: works
working: looking
works: weeks workers world
world: could works would
would: could found should world
years: means
yesterday: 

