aktien: halten hatten hätten keinen medien parteien setzen
allein: anteil arbeit eltern halten kleine sollen verein wollen zahlen
allerdings: 
amerikanische: amerikanischen
amerikanischen: amerikanische
andere: anderem anderen anderer anderes anders anteil handel handelt kinder kindern landes länder ländern sondern unsere unserer ändern
anderem: andere anderen anderer anderes anders außerdem unsere unserer ändern
anderen: andere anderem anderer anderes anders angaben kindern ländern sondern unsere unserer ändern
anderer: andere anderem anderen anderes anders unsere unserer ändern
anderes: andere anderem anderen anderer anders landes unsere unserer ändern
anders: andere anderem anderen anderer anderes anteil handel handelt kinder kindern landes länder ländern sondern unsere ändern
anfang: 
angaben: anderen angebot aufgabe gegeben langen
angebot: angaben
angesichts: ansicht
ansicht: angesichts bericht gericht leicht nichts spricht
anteil: allein andere anders arbeit handel partei urteil
arbeit: allein anteil arbeiten bereit derzeit erneut partei streit urteil vorbei
arbeiten: arbeit beiden besten parteien seiten zeiten zweiten
arbeitsplätze: 
aufgabe: angaben
aufgrund: 
auftrag: 
august: 
ausland: bislang rußland
ausstellung: 
außerdem: anderem
banken: bayern beiden besten bieten bonner bremen bringen chancen finden ganzen halten handel hatten jahren jungen kunden können landes langen lassen machen rahmen zahlen
bayern: banken eltern ändern
bedeutet: bedeutung bietet
bedeutung: bedeutet
begann: beginn beginnt beiden bekannt berlin besten genannt region
beginn: begann beginnt beiden bekannt berlin besten keinen medien region seinen
beginnt: begann beginn bekannt bericht bringt genannt region
behörden: beiden gehören geworden werden
beiden: arbeiten banken begann beginn behörden berlin besser besten bieten bilder bleiben bremen bringen dessen eigene finden gelten helfen keinen keiner kleinen kunden leiter medien meisten nehmen seinem seinen seiner seines seiten setzen weiter wenigen werden westen worden wurden würden zeigen zeiten zweiten
beispiel: 
beispielsweise: 
bekannt: begann beginn beginnt genannt
bekommen: gekommen genommen kommen
bereich: bereit bereits bericht berlin erreicht gericht gleich verein vergleich
bereit: arbeit bereich bereits bericht berlin besteht bietet bleibt derzeit direkt erneut mehrheit streit verein
bereits: bereich bereit berlin derzeit jeweils streit verein
bericht: ansicht beginnt bereich bereit berichtet berichtete besteht braucht bringt erreicht gebracht gemacht gericht leicht spricht versucht
berichtet: bericht berichtete bezeichnet gericht richter
berichtete: bericht berichtet
berlin: begann beginn beiden bereich bereit bereits berliner besten verein werden
berliner: berlin keiner seiner trainer
besonders: sondern
besser: beiden besteht besten besucher bilder bisher bonner bürger dessen dieser gestern keiner lassen leiter müssen seiner wasser weiter westen wissen
besteht: bereit bericht besser besten bietet gestellt gestern westen
besten: arbeiten banken begann beginn beiden berlin besser besteht bieten bietet bisher bleiben bremen dessen diesen eltern ersten gelten gesamten gesehen gestern halten hatten helfen hätten keinen kosten lassen leiter letzten medien meisten mußten müssen müßten nehmen seinen seiten setzen system weiter werden westen wissen zeigen zeiten zweiten
besucher: besser bisher sicher suchen
betonte: letzte meinte
bevölkerung: 
bezeichnet: berichtet
bieten: banken beiden besten bietet bilder bisher bleiben bremen bringen diesem diesen dieser dieses dritten eigenen ersten finden firmen gelten halten hatten hinter hätten kosten liegen meisten minuten mittel mußten müßten seiten setzen sieben spielen stehen vielen westen wieder wissen zeiten ziehen zweiten
bietet: bedeutet bereit besteht besten bieten bilder bisher bleibt bremen diesem diesen dieser dieses findet hinter liegen mittel sieben vielen wieder ziehen
bilder: beiden besser bieten bietet bisher bonner bürger dieser finden findet hinter kinder kindern länder sicher wieder
bisher: besser besten besucher bieten bietet bilder bonner bürger dieser früher hinter kinder richter sicher wasser wieder wissen ziehen
bislang: ausland
bleiben: beiden besten bieten bleibt bremen gleichen keinen kleine kleinen leiter seinen seiten sieben zeigen zeiten zweiten
bleibt: bereit bietet bleiben gleich kleine leicht
bonner: banken besser bilder bisher bürger hinter keiner kinder konnte konnten können länder männer seiner sommer sondern
braucht: bericht gebracht versucht
bremen: banken beiden besten bieten bietet bleiben bringen diesen ersten firmen fragen frauen großen grünen kommen liegen nehmen rahmen sieben stehen tragen vielen ziehen
bringen: banken beiden bieten bremen bringt dritten einigen finden fragen grünen jungen keinen langen liegen seinen tragen zeigen
bringt: beginnt bericht bringen
bundesregierung: 
bundesrepublik: 
bürger: besser bilder bisher bonner dürfen würden
bürgermeister: 
chance: chancen handel
chancen: banken chance ganzen halten handel hatten langen schaffen
dadurch: danach
dagegen: diesen eigenen gegeben hingegen langen liegen
damals: danach darauf
danach: dadurch damals darauf dennoch einfach mensch sprach
darauf: damals danach heraus
darunter: darüber
darüber: darunter früher
dennoch: danach jedoch mensch
derzeit: arbeit bereit bereits direkt erneut mehrheit streit verein
deshalb: 
dessen: beiden besser besten diesem diesen dieser dieses dürfen ersten gelten gesehen gestern gewesen helfen keinen kosten lassen medien meisten müssen nehmen seinen seiten setzen wasser werden westen wissen zeigen zeiten
deutlich: deutsche endlich
deutsche: deutlich deutschen
deutschen: deutsche deutschland menschen
deutschland: deutschen
dezember: november september
dienstag: 
diesem: bieten bietet dessen diesen dieser dieses liegen sieben vielen wieder wissen ziehen
diesen: besten bieten bietet bremen dagegen dessen diesem dieser dieses dritten dürfen eigenen finden firmen gewesen lassen liegen müssen sieben spielen stehen vielen westen wieder wissen ziehen
dieser: besser bieten bietet bilder bisher dessen diesem diesen dieses hinter kinder liegen sicher sieben spieler vielen wasser wieder wissen ziehen
dieses: bieten bietet dessen diesem diesen dieser liegen sieben vielen wieder wissen ziehen
direkt: bereit derzeit streit
diskussion: 
dollar: sollen sollte wollen wollte
donnerstag: 
drittel: dritten mittel
dritten: bieten bringen diesen drittel ersten größten hatten hätten meisten mittel seiten zeiten
durchaus: 
dürfen: bürger dessen diesen dürfte firmen führen helfen müssen müßten werden worden wurden würden
dürfte: dürfen hälfte
ebenfalls: jedenfalls
ebenso: 
ehemalige: ehemaligen
ehemaligen: ehemalige
eigene: beiden eigenen einige einigen keinen liegen seinen seiten weitere wenigen zeigen zeigte zeiten
eigenen: bieten dagegen diesen eigene einigen einzelnen gegeben hingegen keinen liegen seinen sieben vielen weiteren zeigen ziehen
eigentlich: 
einfach: danach einmal einsatz
einige: eigene einigen einmal einzige meinte wenige wenigen weniger
einigen: bringen eigene eigenen einige einzige finden heutigen hingegen jungen keinen langen liegen minuten seinen wenige wenigen weniger zeigen
einmal: einfach einige einsatz
einsatz: einfach einmal umsatz
einzelnen: eigenen
einzige: einige einigen wenige
eltern: allein bayern besten ersten gelten gestern halten helfen leiter seiten weiter weitere weiteren westen zeiten ändern
endlich: deutlich möglich nämlich
entscheiden: entscheidung entschieden
entscheidung: entscheiden
entschieden: entscheiden
entwickelt: 
entwicklung: 
erfolg: zufolge
ergebnis: 
erhalten: ersten erwarten erwartet halten hatten
erklärt: erklärte
erklärte: erklärt
erneut: arbeit bereit derzeit
erreichen: erreicht gleichen sprechen
erreicht: bereich bericht erreichen gericht leicht spricht
ersten: besten bieten bremen dessen dritten eltern erhalten erwarten fragen frauen gelten gestern großen größten grünen halten hatten hätten kosten lassen letzten meisten mußten müssen müßten personen seiten system tragen werden westen wissen zeiten
erstmals: 
erwarten: erhalten ersten erwartet experten
erwartet: erhalten erwarten
erzählt: 
europa: 
europäischen: 
experten: erwarten
familie: 
februar: 
finden: banken beiden bieten bilder bringen diesen einigen findet firmen folgen fragen frauen führen ganzen gefunden handel hinter jungen keinen kinder kindern kunden können landes langen liegen london länder ländern minuten seinen sieben sondern stunden vielen werden wieder wissen worden wurden würden ziehen ändern
findet: bietet bilder finden firmen fordert handel handelt hinter kinder kindern kunden landes länder wieder
firmen: bieten bremen diesen dürfen finden findet folgen fragen frauen führen kommen liegen nehmen rahmen sieben stimmen vielen werden wissen worden wurden würden ziehen
folgen: finden firmen fragen frauen führen gelten halten helfen jungen kollegen kommen kosten langen liegen solchen sollen sollten tragen wochen wollen wollten worden zeigen zufolge
fordert: findet forderte sondern worden
forderte: fordert
fragen: bremen bringen ersten finden firmen folgen frauen früher führen großen grünen jungen langen liegen rahmen tragen zeigen
frankfurt: frankfurter
frankfurter: frankfurt
frankreich: 
französischen: 
frauen: bremen ersten finden firmen folgen fragen früher führen großen grünen rahmen tragen
freilich: 
freitag: 
früher: bisher darüber fragen frauen früheren führen großer grünen sicher
früheren: früher führen
funktion: 
führen: dürfen finden firmen folgen fragen frauen früher früheren führung gehören jahren jahres müssen müßten nehmen rahmen wählen während würden zahlen
führung: führen
ganzen: banken chancen finden gelten großen grünen halten handel hatten jahren jungen kunden können landes langen lassen machen rahmen setzen zahlen
gebracht: bericht braucht gemacht gericht
gefahr: geführt gemacht gerade gesagt gewalt
gefunden: finden gewinnen geworden kunden stunden
geführt: gefahr gehört
gegeben: angaben dagegen eigenen gegenüber gehören gelten gesehen gewesen sieben
gegenüber: gegeben
gehören: behörden führen gegeben gehört gelten gesehen gewesen geworden jahren nehmen
gehört: geführt gehören gesagt gewalt
gekommen: bekommen genommen gesamten geworden kommen
gelten: beiden besten bieten dessen eltern ersten folgen ganzen gegeben gehören geplanten gesamten gesehen gestern gewesen großen größten grünen halten hatten helfen hätten keinen kosten leiter letzten medien meisten mußten müßten nehmen seinen seiten setzen sollen sollten stellen teilte vielen weiter werden westen wollen wollten zeigen zeiten zweiten
gemacht: bericht gebracht gefahr genannt gericht gesagt gewalt leicht machte
gemeinsam: 
genannt: begann beginnt bekannt gemacht geplant gesagt gewalt
genommen: bekommen gekommen gesamten geworden kommen
geplant: genannt geplanten gesagt gewalt
geplanten: gelten geplant gesamten
gerade: gefahr gesagt gesamte gewalt heraus straße werden
gericht: ansicht bereich bericht berichtet erreicht gebracht gemacht gleich leicht spricht versucht
gesagt: gefahr gehört gemacht genannt geplant gerade gesamte gesamten gesetz gesetzt gewalt
gesamte: gerade gesagt gesamten gesetz gewalt
gesamten: besten gekommen gelten genommen geplanten gesagt gesamte gesehen gestern westen zusammen
geschichte: 
geschäft: 
gesehen: besten dessen gegeben gehören gelten gesamten gesetz gesetzt gestern gewesen gleichen menschen stehen westen ziehen
gesellschaft: 
gesetz: gesagt gesamte gesehen gesetzt gestern umsatz
gesetzt: gesagt gesehen gesetz gestellt verletzt zuletzt
gespräch: sprach
gestellt: besteht gesetzt gestern stelle stellt stellte
gestern: besser besteht besten dessen eltern ersten gelten gesamten gesehen gesetz gestellt kosten leiter meisten seiten weiter weitere weiteren westen zeiten
gewalt: gefahr gehört gemacht genannt geplant gerade gesagt gesamte
gewesen: dessen diesen gegeben gehören gelten gesehen gewinnen geworden westen
gewinnen: gefunden gewesen geworden keinen seinen
geworden: behörden gefunden gehören gekommen genommen gewesen gewinnen werden worden wurden würden
gleich: bereich bleibt gericht gleichen kleine leicht möglich vergleich zugleich
gleichen: bleiben erreichen gesehen gleich kleinen leicht
gleichzeitig: 
großen: bremen ersten fragen frauen ganzen gelten großer größte größten grünen prozent tragen
großer: früher großen größte größten grünen
gruppe: größte
größte: großen großer gruppe größten
größten: dritten ersten gelten großen großer größte grünen mußten müßten
grünen: bremen bringen ersten fragen frauen früher ganzen gelten großen großer größten keinen können seinen tragen
halten: aktien allein banken besten bieten chancen eltern erhalten ersten folgen ganzen gelten handel hatten helfen hinter hälfte hätten italien jahren kosten langen lassen machen mußten müßten partei rahmen seiten sollen sollten staaten westen wollen wollten zahlen zeiten
hamburg: hamburger
hamburger: hamburg
handel: andere anders anteil banken chance chancen finden findet ganzen halten handelt hatten hinter kinder kunden landes langen länder
handelt: andere anders findet handel landes
hatten: aktien banken besten bieten chancen dritten erhalten ersten ganzen gelten halten handel helfen hinter hätten jahren kosten langen lassen letzten machen mittel mutter mußten müßten partei rahmen seiten setzen staaten westen zahlen zeiten
hauptstadt: 
helfen: beiden besten dessen dürfen eltern folgen gelten halten hatten hälfte hätten keinen medien nehmen seinen seiten setzen sollen stellen vielen werden westen wollen zeigen zeiten
heraus: darauf gerade hinaus
heutigen: einigen wenigen zeigen
hinaus: heraus hinter
hingegen: dagegen eigenen einigen liegen
hinter: bieten bietet bilder bisher bonner dieser finden findet halten handel hatten hinaus hätten keiner kinder kindern leiter länder meinte minister minuten mittel mutter männer richter seiner sicher später theater weiter wieder
hälfte: dürfte halten helfen hätten häufig sollte wollte
hätten: aktien besten bieten dritten ersten gelten halten hatten helfen hinter hälfte kosten letzten mittel mutter mußten müßten seiten setzen westen wählen zeiten
häufig: hälfte
immerhin: 
industrie: 
informationen: 
innerhalb: 
insbesondere: 
insgesamt: 
interesse: 
internationalen: 
internet: 
inzwischen: zwischen
italien: halten staaten stellen
jahren: banken führen ganzen gehören halten hatten jahres jungen langen lassen machen nehmen rahmen wählen während zahlen
jahres: führen jahren landes rahmen zahlen
januar: 
jedenfalls: ebenfalls
jedoch: dennoch mensch
jeweils: bereits
jungen: banken bringen einigen finden folgen fragen ganzen jahren kunden können langen liegen mußten stunden suchen tragen wenigen wurden zeigen
jährlich: nämlich
keinen: aktien beginn beiden besten bleiben bringen dessen eigene eigenen einigen finden gelten gewinnen grünen helfen keiner kinder kindern kleine kleinen kommen konnten kosten kunden können könnten leiter medien meinte meinung meisten nehmen rechnen seinem seinen seiner seines seiten setzen weiter wenigen werden westen zeigen zeiten zweiten
keiner: beiden berliner besser bonner hinter keinen kinder kindern kleine kleinen können leiter meinte männer seinem seinen seiner seines seiten trainer weiter weitere weniger zeigen zeiten
kilometer: 
kinder: andere anders bilder bisher bonner dieser finden findet handel hinter keinen keiner kindern kunden können landes länder ländern männer seiner sicher sondern wieder ändern
kindern: andere anderen anders bilder finden findet hinter keinen keiner kinder kunden können länder ländern sondern wieder ändern
kirche: sicher solche sprache welche
kleine: allein bleiben bleibt gleich keinen keiner kleinen leiter meinte seinem seinen seiner seines zweite
kleinen: beiden bleiben gleichen keinen keiner kleine können leiter seinem seinen seiner seines seiten zeigen zeiten zweiten
koalition: position
kollegen: folgen liegen sollen sollten wollen wollten
kommen: bekommen bremen firmen folgen gekommen genommen keinen kommenden konnten kosten kunden können nehmen rahmen sollen sommer stimmen wochen wollen worden
kommenden: kommen
konnte: bonner konnten kosten können könnte könnten meinte monate monaten punkte sollte sonntag wollte
konnten: bonner keinen kommen konnte kosten kunden können könnte könnten minuten monate monaten sollten sonntag wollten
konzept: 
kosten: besten bieten dessen ersten folgen gelten gestern halten hatten hätten keinen kommen konnte konnten kunden können könnten lassen meisten monaten mußten müssen müßten seiten sollen sollten system westen wissen wochen wollen wollten worden zeiten
kritik: politik
kultur: mutter
kunden: banken beiden finden findet ganzen gefunden handel jungen keinen kinder kindern kommen konnten kosten können könnten landes langen london länder ländern mußten sondern stunde stunden suchen werden worden wurden würden ändern
können: banken bonner finden ganzen grünen jungen keinen keiner kinder kindern kleinen kommen konnte konnten kosten kunden könnte könnten langen männer seinen
könnte: konnte konnten können könnten meinte monate möchte punkte
könnten: keinen konnte konnten kosten kunden können könnte minuten monaten
künftig: 
landes: andere anderes anders banken finden findet ganzen handel handelt jahres kinder kunden langen lassen london länder ländern
langen: angaben banken bringen chancen dagegen einigen finden folgen fragen ganzen halten handel hatten jahren jungen kunden können landes lassen liegen london länder ländern längst machen rahmen tragen wenigen zahlen zeigen
lassen: banken besser besten dessen diesen ersten ganzen halten hatten jahren kosten landes langen liegen machen müssen rahmen saison verlassen wasser westen wissen zahlen
lediglich: 
leicht: ansicht bericht bleibt erreicht gemacht gericht gleich gleichen leiter nichts spricht welche
leiter: beiden besser besten bleiben eltern gelten gestern hinter keinen keiner kleine kleinen leicht letzte letzten länder meinte meisten mutter seinem seinen seiner seines seiten später teilte theater weiter weitere weiteren weniger westen zeigen zeigte zeiten zweite zweiten
letzte: betonte leiter letzten meinte setzen teilte zeigte zuletzt
letzten: besten ersten gelten hatten hätten leiter letzte meisten seiten setzen westen zeiten
liegen: bieten bietet bremen bringen dagegen diesem diesen dieser dieses eigene eigenen einigen finden firmen folgen fragen hingegen jungen kollegen langen lassen sieben spielen stehen tragen vielen wieder wissen zeigen ziehen
london: finden kunden landes langen länder ländern sondern worden
länder: andere anders bilder bonner finden findet handel hinter kinder kindern kunden landes langen leiter london ländern längst männer sondern wieder ändern
ländern: andere anderen anders finden kinder kindern kunden landes langen london länder männer sondern ändern
längst: langen länder
lösung: 
machen: banken ganzen halten hatten jahren langen lassen machte medien menschen mußten mädchen möchte münchen müssen müßten nachdem rahmen rechnen sicher solchen stehen suchen wochen zahlen ziehen
machte: gemacht machen meinte monate möchte nachdem nichts richter tochter
mannschaft: 
medien: aktien beginn beiden besten dessen gelten helfen keinen machen meisten mußten mädchen müssen müßten nehmen region seinen seiten setzen wenigen werden westen zeigen zeiten
mehrere: mehrheit weitere
mehrheit: bereit derzeit mehrere
meinte: betonte einige hinter keinen keiner kleine konnte könnte leiter letzte machte meinung meisten minuten mittel monate möchte seinem seinen seiner seines seiten teilte weiter zeigte zeiten zweite
meinung: keinen meinte seinen
meisten: beiden besten bieten dessen dritten ersten gelten gestern keinen kosten leiter letzten medien meinte menschen minister minuten mittel monaten mußten müssen müßten seinen seiten teilte weiter westen wissen zeigen zeigte zeiten zweiten
mensch: danach dennoch jedoch menschen
menschen: deutschen gesehen machen meisten mensch mädchen münchen zwischen
milliarden: millionen
millionen: milliarden
mindestens: 
minister: hinter meisten minuten
ministerpräsident: 
minuten: bieten einigen finden hinter konnten könnten meinte meisten minister mittel monate monaten mußten münchen müßten
mitarbeiter: 
mitglieder: 
mittel: bieten bietet drittel dritten hatten hinter hätten meinte meisten minuten mutter mußten müßten
mittlerweile: 
mittwoch: 
monate: konnte konnten könnte machte meinte minuten monaten montag möchte punkte sollte wollte
monaten: konnte konnten kosten könnten meisten minuten monate montag mußten münchen müßten soldaten sollten staaten wollten
montag: monate monaten moskau sonntag
moskau: montag
mutter: hatten hinter hätten kultur leiter mittel mußten männer müßten später weiter
mußten: besten bieten ersten gelten größten halten hatten hätten jungen kosten kunden machen medien meisten minuten mittel monaten mutter müssen müßten seiten suchen westen wurden zeiten
mädchen: machen medien menschen münchen solchen suchen wochen
männer: bonner hinter keiner kinder können länder ländern mutter münchner seiner ändern
möchte: könnte machen machte meinte monate nichts richter tochter
möglich: endlich gleich nämlich zugleich
möglichkeit: 
münchen: machen menschen minuten monaten mädchen münchner müssen müßten solchen suchen wochen
münchner: männer münchen
müssen: besser besten dessen diesen dürfen ersten führen kosten lassen machen medien meisten mußten münchen müßten wasser westen wissen würden
müßten: besten bieten dürfen ersten führen gelten größten halten hatten hätten kosten machen medien meisten minuten mittel monaten mutter mußten münchen müssen seiten westen würden zeiten
nachdem: machen machte
natürlich: 
nehmen: beiden besten bremen dessen firmen führen gehören gelten helfen jahren keinen kommen medien rahmen rechnen seinen seiten setzen stehen werden westen wählen zahlen zeigen zeiten ziehen
nichts: ansicht leicht machte möchte richter richtig sicher wichtig
niemand: 
november: dezember
nächsten: 
nämlich: endlich jährlich möglich
obwohl: sowohl
offenbar: 
ohnehin: 
oktober: 
parlament: 
partei: anteil arbeit halten hatten parteien urteil vorbei
parteien: aktien arbeiten partei
personen: ersten verloren
politik: kritik politiker polizei position
politiker: politik
politische: politischen
politischen: politische
polizei: politik
position: koalition politik
problem: probleme
probleme: problem
produktion: 
programm: 
projekt: prozent
prozent: großen projekt
präsident: präsidenten
präsidenten: präsident
publikum: 
punkte: konnte könnte monate
rahmen: banken bremen firmen fragen frauen führen ganzen halten hatten jahren jahres kommen langen lassen machen nehmen rechnen tragen wählen zahlen
rechnen: keinen machen nehmen rahmen richter seinen sprechen suchen wochen
regierung: 
region: begann beginn beginnt medien
richter: berichtet bisher hinter machte möchte nichts rechnen richtig richtung schwer sicher tochter wichtig
richtig: nichts richter richtung wichtig
richtung: richter richtig wichtig
russischen: 
rußland: ausland
saison: lassen seinen seiten
samstag: sonntag
schaffen: chancen
scheint: schritt streit suchen
schließlich: 
schnell: schule schwer
schritt: scheint
schule: schnell schwer schüler stelle
schwer: richter schnell schule schüler seiner sicher sommer später suchen tochter
schüler: schule schwer sicher spieler
seinem: beiden keinen keiner kleine kleinen leiter meinte seinen seiner seines seiten setzen system weiter zeigen zeiten
seinen: beginn beiden besten bleiben bringen dessen eigene eigenen einigen finden gelten gewinnen grünen helfen keinen keiner kleine kleinen können leiter medien meinte meinung meisten nehmen rechnen saison seinem seiner seines seiten setzen sieben sollen spielen stehen stellen stimmen stunden suchen weiter wenigen werden westen zeigen zeiten zweiten
seiner: beiden berliner besser bonner hinter keinen keiner kinder kleine kleinen leiter meinte männer schwer seinem seinen seines seiten setzen sicher sommer spieler später trainer weiter weitere weniger zeigen zeiten
seines: beiden keinen keiner kleine kleinen leiter meinte seinem seinen seiner seiten setzen weiter zeigen zeiten
seiten: arbeiten beiden besten bieten bleiben dessen dritten eigene eltern ersten gelten gestern halten hatten helfen hätten keinen keiner kleinen kosten leiter letzten medien meinte meisten mußten müßten nehmen saison seinem seinen seiner seines setzen sieben sollen sollten spielen später staaten stehen stellen stimmen suchen system teilte weiter weitere weiteren wenigen werden westen zeigen zeigte zeiten zweite zweiten
selbst: stellt
september: dezember
setzen: aktien beiden besten bieten dessen ganzen gelten hatten helfen hätten keinen letzte letzten medien nehmen seinem seinen seiner seines seiten sieben sollen stehen stellen suchen werden westen zeigen zeiten
sicher: besucher bilder bisher dieser früher hinter kinder kirche machen nichts richter schwer schüler seiner sieben solche solchen sommer spieler sprecher später stehen suchen tochter wieder wochen ziehen
sicherheit: 
sieben: bieten bietet bleiben bremen diesem diesen dieser dieses eigenen finden firmen gegeben liegen seinen seiten setzen sicher sollen spielen spieler stehen stellen stimmen suchen vielen wieder wissen ziehen
situation: 
sofort: sowohl
sogenannten: 
solche: kirche sicher solchen sollen sollte sollten sowohl sprache suchen welche wochen wollte
solchen: folgen machen mädchen münchen sicher solche soldaten sollen sollte sollten sprechen stehen suchen welche wochen wollen wollten
soldaten: monaten solchen sollen sollte sollten staaten wollten
sollen: allein dollar folgen gelten halten helfen kollegen kommen kosten seinen seiten setzen sieben solche solchen soldaten sollte sollten sommer sondern spielen stehen stelle stellen suchen vielen wochen wollen wollte wollten worden wählen zahlen
sollte: dollar hälfte konnte monate solche solchen soldaten sollen sollten stelle stellt stellte teilte wollen wollte wollten
sollten: folgen gelten halten kollegen konnten kosten monaten seiten solche solchen soldaten sollen sollte staaten stellen stellte wollen wollte wollten
sommer: bonner kommen schwer seiner sicher sollen sondern später stimmen
sondern: andere anderen anders besonders bonner finden fordert kinder kindern kunden london länder ländern sollen sommer stunden worden ändern
sonntag: konnte konnten montag samstag
sowohl: obwohl sofort solche
spielen: bieten diesen liegen seinen seiten sieben sollen spieler spielt sprechen stehen stellen stimmen vielen ziehen
spieler: dieser schüler seiner sicher sieben spielen spielt sprecher später vielen wieder
spielt: spielen spieler spricht stellt streit
sprach: danach gespräch sprache sprechen sprecher spricht straße
sprache: kirche solche sprach sprechen sprecher spricht straße
sprechen: erreichen rechnen solchen spielen sprach sprache sprecher spricht stehen suchen
sprecher: sicher spieler sprach sprache sprechen spricht
spricht: ansicht bericht erreicht gericht leicht spielt sprach sprache sprechen sprecher
später: hinter leiter mutter schwer seiner seiten sicher sommer spieler stärker system weiter
staaten: halten hatten italien monaten seiten soldaten sollten stehen stellen stimmen straße stunden tragen
stehen: bieten bremen diesen gesehen liegen machen nehmen seinen seiten setzen sicher sieben solchen sollen spielen sprechen staaten stelle stellen stellt stimmen stunden suchen vielen wochen ziehen
stelle: gestellt schule sollen sollte stehen stellen stellt stellte straße stunde teilte
stellen: gelten helfen italien seinen seiten setzen sieben sollen sollten spielen staaten stehen stelle stellt stellte stimmen stunden vielen wollen
stellt: gestellt selbst sollte spielt stehen stelle stellen stellte streit teilte
stellte: gestellt sollte sollten stelle stellen stellt teilte wollte
stimmen: firmen kommen seinen seiten sieben sommer spielen staaten stehen stellen stunden
straße: gerade sprach sprache staaten stelle streit stunde tragen
streit: arbeit bereit bereits derzeit direkt scheint spielt stellt straße verein
studenten: stunden
stunde: kunden stelle straße stunden
stunden: finden gefunden jungen kunden seinen sondern staaten stehen stellen stimmen studenten stunde suchen wurden
stuttgart: stuttgarter
stuttgarter: stuttgart
stärker: später
suchen: besucher jungen kunden machen mußten mädchen münchen rechnen scheint schwer seinen seiten setzen sicher sieben solche solchen sollen sprechen stehen stunden wochen wurden ziehen
system: besten ersten kosten seinem seiten später westen
tatsächlich: 
teilte: gelten leiter letzte meinte meisten seiten sollte stelle stellt stellte weiter wollte zeigte zeiten zweite
theater: hinter leiter tochter weiter
tochter: machte möchte richter schwer sicher theater wochen
tragen: bremen bringen ersten folgen fragen frauen großen grünen jungen langen liegen rahmen staaten straße trainer zeigen
trainer: berliner keiner seiner tragen
umsatz: einsatz gesetz
universität: 
unsere: andere anderem anderen anderer anderes anders unserer ändern
unserer: andere anderem anderen anderer anderes unsere
unternehmen: übernehmen
unterstützung: 
urteil: anteil arbeit partei
verein: allein bereich bereit bereits berlin derzeit streit vielen vorbei werden
verfahren: verlassen verloren
verfügung: 
vergangenen: vergangenheit
vergangenheit: vergangenen
vergleich: bereich gleich zugleich
verhandlungen: 
verhindern: 
verkauft: 
verlassen: lassen verfahren verloren
verletzt: gesetzt zuletzt
verloren: personen verfahren verlassen
verschiedenen: 
versucht: bericht braucht gericht
vertreter: 
verwendet: 
vielen: bieten bietet bremen diesem diesen dieser dieses eigenen finden firmen gelten helfen liegen sieben sollen spielen spieler stehen stellen verein wieder wissen wollen wählen zahlen ziehen
vielleicht: 
vorbei: arbeit partei verein worden
vorjahr: 
vorsitzende: 
völlig: 
wasser: besser bisher dessen dieser lassen müssen weiter westen wieder wissen
weiter: beiden besser besten eltern gelten gestern hinter keinen keiner leiter meinte meisten mutter seinem seinen seiner seines seiten später teilte theater wasser weitere weiteren weiterhin wenige wenigen weniger werden westen wieder zeigen zeigte zeiten zweite zweiten
weitere: eigene eltern gestern keiner leiter mehrere seiner seiten weiter weiteren weiterhin weniger westen zeiten zweite zweiten
weiteren: eigenen eltern gestern leiter seiten weiter weitere weiterhin westen zeiten zweiten
weiterhin: weiter weitere weiteren
welche: kirche leicht solche solchen wenige wochen wollte
weltweit: 
wenige: einige einigen einzige weiter welche wenigen weniger zeigen zeigte zweite
wenigen: beiden eigene einige einigen heutigen jungen keinen langen medien seinen seiten weiter wenige weniger werden westen zeigen zeiten zweiten
weniger: einige einigen keiner leiter seiner weiter weitere wenige wenigen zeigen
werden: behörden beiden berlin besten dessen dürfen ersten finden firmen gelten gerade geworden helfen keinen kunden medien nehmen seinen seiten setzen verein weiter wenigen westen wieder wissen wochen wollen worden wurden wählen würden zeigen zeiten zweiten
westen: beiden besser besteht besten bieten dessen diesen eltern ersten gelten gesamten gesehen gestern gewesen halten hatten helfen hätten keinen kosten lassen leiter letzten medien meisten mußten müssen müßten nehmen seinen seiten setzen system wasser weiter weitere weiteren wenigen werden wissen wochen wollen wollten worden wurden wählen würden zeigen zeiten zweite zweiten
wichtig: nichts richter richtig richtung
wieder: bieten bietet bilder bisher diesem diesen dieser dieses finden findet hinter kinder kindern liegen länder sicher sieben spieler vielen wasser weiter werden wissen worden wurden würden ziehen
wirklich: 
wirtschaft: 
wissen: besser besten bieten bisher dessen diesem diesen dieser dieses ersten finden firmen kosten lassen liegen meisten müssen sieben vielen wasser werden westen wieder wochen wollen worden wurden wählen würden ziehen zwischen
wochen: folgen kommen kosten machen mädchen münchen rechnen sicher solche solchen sollen stehen suchen tochter welche werden westen wissen wollen wollten worden wurden wählen würden ziehen zwischen
wochenende: 
wollen: allein dollar folgen gelten halten helfen kollegen kommen kosten solchen sollen sollte sollten stellen vielen werden westen wissen wochen wollte wollten worden wurden wählen würden zahlen
wollte: dollar hälfte konnte monate solche sollen sollte sollten stellte teilte welche wollen wollten
wollten: folgen gelten halten kollegen konnten kosten monaten solchen soldaten sollen sollte sollten westen wochen wollen wollte worden wählen
worden: beiden dürfen finden firmen folgen fordert geworden kommen kosten kunden london sollen sondern vorbei werden westen wieder wissen wochen wollen wollten wurden wählen würden
wurden: beiden dürfen finden firmen geworden jungen kunden mußten stunden suchen werden westen wieder wissen wochen wollen worden wählen würden
wählen: führen hätten jahren nehmen rahmen sollen vielen werden westen wissen wochen wollen wollten worden wurden während würden zahlen
während: führen jahren wählen
würden: beiden bürger dürfen finden firmen führen geworden kunden müssen müßten werden westen wieder wissen wochen wollen worden wurden wählen
zahlen: allein banken führen ganzen halten hatten jahren jahres langen lassen machen nehmen rahmen sollen vielen wollen wählen zeigen zeiten ziehen
zeigen: beiden besten bleiben bringen dessen eigene eigenen einigen folgen fragen gelten helfen heutigen jungen keinen keiner kleinen langen leiter liegen medien meisten nehmen seinem seinen seiner seines seiten setzen tragen weiter wenige wenigen weniger werden westen zahlen zeigte zeiten ziehen zweite zweiten
zeigte: eigene leiter letzte meinte meisten seiten teilte weiter wenige zeigen zeiten zweite zweiten
zeiten: arbeiten beiden besten bieten bleiben dessen dritten eigene eltern ersten gelten gestern halten hatten helfen hätten keinen keiner kleinen kosten leiter letzten medien meinte meisten mußten müßten nehmen seinem seinen seiner seines seiten setzen teilte weiter weitere weiteren wenigen werden westen zahlen zeigen zeigte ziehen zweite zweiten
ziehen: bieten bietet bisher bremen diesem diesen dieser dieses eigenen finden firmen gesehen liegen machen nehmen sicher sieben spielen stehen suchen vielen wieder wissen wochen zahlen zeigen zeiten zweiten zwischen
zufolge: erfolg folgen
zugleich: gleich möglich vergleich
zukunft: 
zuletzt: gesetzt letzte verletzt
zumindest: 
zunächst: 
zurück: 
zusammen: gesamten
zusammenarbeit: 
zusammenhang: 
zuschauer: 
zweite: kleine leiter meinte seiten teilte weiter weitere wenige westen zeigen zeigte zeiten zweiten
zweiten: arbeiten beiden besten bieten bleiben gelten keinen kleinen leiter meisten seinen seiten weiter weitere weiteren wenigen werden westen zeigen zeigte zeiten ziehen zweite
zwischen: inzwischen menschen wissen wochen ziehen
ändern: andere anderem anderen anderer anderes anders bayern eltern finden kinder kindern kunden länder ländern männer sondern unsere
öffentlichen: öffentlichkeit
öffentlichkeit: öffentlichen
überhaupt: 
übernehmen: unternehmen

